abandon оставить
abate|уменьшаться
abduct|похищать
abide|смириться
able|способный
abnormal|ненормальный
aboard|на борту
abolish|упразднять
abort|прерывать
abound|изобиловать
about|примерно
abroad|за границу
abrupt|крутой
absent|отсутствующий
absorb|впитывать
abundant|обильный
abuse|оскорблять
abuse|злоупотреблять
abuse|насилие
accelerate|ускорять
accept|принять
access|доступ
accessory|принадлежность
accident|случайность
accident|происшествие
acclaim|приветствовать
accommodate|размещать
accompany|сопровождать
accomplish|выполнить
accord|согласие
according to|в соответствии
account|счет
account|отчет
account for|объяснить
accurate|точный
accuse|обвинять
accustom|приучить
ache|боль
achieve|достигать
acid|кислота
acknowledge|признавать
acquaint|знакомить
acquire|обретать
acquit|оправдать
across|за
act|действовать
act on|действовать в соответствии
acute|острый
adamant|непреклонный
add to|увеличивать
add up|сходиться
addict|наркоман
addition|добавление
adhere|придерживаться
adjacent|смежный
adjective|прилагательное
adjust|настраивать
admire|восхищаться
admit|признавать
adolescent|подросток
adopt|принимать
adopt|усыновить
adore|обожать
adorn|украшать
adult|взрослый
adultery|прелюбодеяние
advance|продвигаться
advantage|преимущество
adventure|приключение
adverb|наречие
adversary|противник
adverse|неблагоприятный
advertise|рекламировать
advice|совет
advise|советовать
advocate|защищать
aerial|воздушный
aerial|антенна
affair|дело
affair|роман
affect|воздействовать
affection|привязанность
affiliate|филиал
affirm|утверждать
afflict|поражать
affluent|обеспеченный
afford|позволить себе
afraid|напуганный
after all|все-таки
aftermath|последствие
age|век
age|возраст
agenda|повестка дня
aggravate|обострять
aggregate|совокупный
agile|проворный
agitate|волновать
agree|соглашаться
agreement|соглашение
agriculture|сельское хозяйство
ahead|вперед
aid|помощь
ailment|недомогание
aim|цель
air|вид
airborne|находящийся в воздухе
aircraft|самолет
airline|авиалиния
aisle|проход
akin|похожий
alarm|тревога
alas|увы
albeit|хотя
alert|тревога
alien|чужак
alienate|отчуждать
align|выравнивать
alike|подобно
alive|живой
all along|все время
allege|утверждать
allegiance|верность
allocate|распределять
allot|выделять
allow|разрешать
allow for|выделять
allowance|выплата
allude|намекать
allure|очарование
ally|союзник
almost|почти
alone|в одиночестве
alongside|рядом
aloud|вслух
alter|изменять
alternate|чередовать
although|хотя и
altitude|высота
altogether|в целом
amateur|любитель
amaze|поражать
ambassador|посол
amber|янтарь
ambiguous|двусмысленный
ambulance|скорая помощь
ambush|засада
amend|исправить
amenity|удобство
amid |среди
ammunition|боеприпасы
amount|количество
ample|обильный
amplify|усиливать
amuse|развлечь
ancestor|предок
anchor|якорь
ancient|древний
anew|заново
anger|гнев
angle|угол
angry|злой
anguish|мука
animate|живой
ankle|лодыжка
anniversary|годовщина
announce|объявлять
annoy|раздражать
annual|ежегодный
ant|муравей
anthem|гимн
anticipate|ожидать
antique|старинный
anxiety|беспокойство
anxious|озабоченный
anymore|больше не
anytime|в любой момент
anyway|в любом случае
anywhere|где угодно
apart|отдельно
apart from|помимо
apartment|квартира
ape|обезьяна
apiece|каждый
apology|извинение
appal|потрясать
apparent|явный
appeal|обращаться
appear|появиться
appear|казаться
applause|аплодисменты
appliance|прибор
apply|применять
apply|обращаться
appoint|назначать
appraise|оценивать
appreciate|ценить
apprentice|ученик
approach|приближаться
appropriate|присвоить
appropriate|подходящий
approve|утвердить
approve of|одобрять
approximate|приблизительный
apron|фартук
apt|склонный
aquatic|водный
arbitrary|произвольный
arc|дуга
arch|арка
archive|архив
area|область
argue|спорить
arise |возникать
arm|рука
armor |броня
arms|оружие
arouse|вызывать
arrange|организовать
array|ряд
arrest|задерживать
arrive|прибывать
arrogant|высокомерный
arrow|стрела
arson|поджог
article|статья
article|вещь
artificial|искусственный
as though|как будто
as well|также
as well as|так же как и
ascend|восходить
ascertain|выяснить
ash|пепел
ashamed|пристыженный
ashtray|пепельница
aside|в стороне
aside from|кроме
ask around|поспрашивать
ask out|пригласить сходить
asleep|спящий
aspire|стремиться
ass|жопа
assassin|убийца
assault|нападение
assemble|собирать
assert|утверждать
assess|оценить
asset|актив
assign|назначать
assimilate|усваивать
assist|помогать
associate|общаться
assume|принимать на себя
assume|предпогалать
assure|уверять
astonish|изумлять
astound|изумлять
asylum|убежище
at all|совсем
at first|сначала
at last|наконец
at least|по крайней мере
at odds with|в противоречии
at once|сразу
at the moment|сейчас
atop|наверху
atrocity|зверство
attach|прикрепить
attack|нападать
attain|достигать
attempt|попытка
attend|уделить внимание
attic|чердак
attitude|отношение
attorney|адвокат
attract|привлекать
attribute|приписывать
audible|слышимый
audience|аудитория
augment|увеличить
aunt|тетя
authorities|органы власти
authority|власть
authorize|дать полномочия
available|доступный
avalanche|лавина
average|средний
avert|предотвращать
avid|заядлый
avoid|избегать
await|ожидать
awake|проснуться
award|награда
aware|осведомленный
awe|трепет
awesome|здорово
awful|ужасный
awhile|какое-то время
awkward|неуклюжий
axe |топор
axis|ось
bachelor|бакалавр
bachelor|холостяк
back down|отступить
back then|тогда
back up|поддержать
backbone|хребет
backdrop|фон
background|происхождение
background|фон
backpack|рюкзак
badge|значок
baffled|в неодумении
bag|сумка
bail|залог
bait|приманка
bake|печь
bald|лысый
bale|тюк
balloon|воздушный шар
ballot|госолование
ban|запрещать
band|ансамбль
bandage|повязка
bang|удар
banish|отгонять
bank|берег
bank on|надеяться
bankrupt|банкрот
banner|знамя
baptize|крестить
bar|пластина
bar|загораживать
barb|шип
barber|парикмахер
bare|голый
barefoot|босиком
barely|едва
bargain|сделка
bark|кора
bark|лаять
barn|сарай
barrel|бочка
barren|бесплодный
bartender|бармен
base|основа
basement|подвал
bash|колотить
basket|корзина
bastard|ублюдок
bat|бита
bat|летучая мышь
batch|партия
bath|ванна
bathe|купаться
batter|паста
battle|битва
bay|залив
be after|иметь целью
be back|возвращаться
be in|участвовать
be into|любить
be keen to|желать
be late|опоздать
be off|отсутствовать
be on fire|гореть
be over|закончиться
be up to|замышлять что-то
bead|шарик
beak|клюв
beam|балка
beam|луч
bean|боб
bear |рожать
bear |нести
beard|борода
beast|зверь
beat |победить
beat |бить
beat up|побить
beauty|красота
beaver|бобр
beckon|манить
beef|говядина
beep|гудок
beetle|жук
beforehand|заранее
beg|просить
behave|вести себя
behavior|поведение
behold|созерцать
beige|бежевый
belief|убеждение
bell|колокол
bellow|реветь
belly|живот
belong to|принадлежать
beloved|любимый
below|ниже
belt|пояс
bench|скамейка
bend |изгибать
bend down|наклониться
beneath|ниже
benefit|польза
benevolent|благожелательный
berry|ягода
berth|койка
beside|рядом
besides|кроме
bestow|даровать
bet|ставка
betray|предавать
beverage|напиток
beware|остерегаться
bewilder|смущать
beyond|вне
bias|склонность
bicycle|велосипед
bid|заявка
bigot|фанатик
bill|счет
bill|банкнота
billboard|рекламный щит
billion|миллиард
bin|ящик
bind |связывать
binge|кутеж
birth|рождение
bishop|епископ
bitch|сука
bite |кусать
bitter|горький
bizarre|странный
black out|обесточить
blackmail|шантажировать
blade|лезвие
blame|винить
bland|пресный
blank|пустой
blanket|одеяло
blast|дуновение
blast|взрыв
blatant|явный
blaze|полыхать
bleach|отбелить
bleak|мрачный
bleed |кровоточить
blend|смешивать
bless|благословлять
blind|слепой
blink|мерцать
bliss|блаженство
blizzard|метель
bloat|раздуваться
block|кусок
block|квартал
block out|блокировать
block up|забиться
blonde|блондинка
bloom|расцвет
blossom|цвести
blouse|блузка
blow |дуть
blow |удар
blow out|задуть
blow over|пройти
blow up|взорвать
blow up|накачивать
bluff|блеф
blunt|тупой
blur|размывать
blush|румянец
board|совет
board|доска
board|борт
boast|хвастать
boat|лодка
bog|болото
boil|кипеть
bold|смелый
bolster|укреплять
bond|связь
bond|обязательство
bone|кость
bonfire|костер
boobs|титьки
book|купить
boom|заграждение
boost|повышать
boot|сапог
booth|будка
booze|выпивка
border|граница
bore|надоедать
borough|район
borrow|брать взаймы
both|оба
bother|беспокоить
bottom|дно
boulder|валун
bounce|отскакивать
bound|обязан
boundary|граница
bounds|границы
bounty|вознаграждение
bout|всплеск
bout|бой
bow|бант
bow|лук
bow|поклон
bow out|откланяться
bowel|кишка
bowl|миска
brace|скоба
bracket|скобка
brag|хвастаться
braid|коса
brake|тормоз
branch|ветвь
branch|филиал
brass|латунь
brassiere |бюстгальтер
brave|храбрый
brawl|шумная драка
brazen|наглый
breach|брешь
breadth|ширина
break|перерыв
break |нарушать
break away|отделяться
break down|ломаться
break into |проникнуть
break out|вспыхнуть
break out|сбежать
break up|разорвать отношения
breakthrough|прорыв
breast|грудь
breath|дыхание
breathe|дышать
breed|порода
breed |разводить
brew|заваривать
bribe|взятка
brick|кирпич
bride|невеста
bridge|мост
brief|краткий
briefcase|портфель
bright|яркий
brilliant|блестящий
brim|край сосуда
bring |принести
bring along|взять с собой
bring around|убедить
bring back|вернуть
bring down|сбрасывать
bring in|привлечь
bring out|выпустить
bring up|поднять тему
bring up|воспитывать
brink|грань
brisk|энергичный
bristle|щетина
brittle|ломкий
broad|широкий
broadcast|транслировать
broom|метла
broth|бульон
bruise|синяк
brush|кисть
brute|животное
bubble|пузырь
buck|самец
bucket|ведро
buckle|пряжка
buckle up|пристегнуться
bud|бутон
buddy|дружище
budge|сдвинуть
buffalo|буйвол
bug|жук
build on|нарастить
built-in|встроенный
bulb|лампа
bulge|бугор
bulk|основная масса
bullet|пуля
bullshit|ерунда
bully|задира
bum|бомж
bump|шишка
bump|удар
bun|булочка
bunch|связка
bundle|связка
bunk|койка
bunny|кролик
burden|бремя
burglar|вор взломщик
burn|жечь
burn down|сгореть
burn out|выгореть
burrow|нора
burst|взрыв
bury|хоронить
bush|куст
bustle|суета
busy|занятый
butcher|мясник
butt|торец
butt|задница
butt in|встревать
butter|масло сливочное
butterfly|бабочка
button|пуговица
buy|верить
buy up|скупить
buzz|жужжать
by chance|случайно
by far|безусловно
by heart|наизусть
by oneself|один
by the way|кстати
bypass|обходить
cab|такси
cabbage|капуста
cabin|хижина
cable|канат
cage|клетка
calf |теленок
call back|перезвонить
call for|требовать
call off|отменить
call on|обратиться
calm|спокойный
calm down|успокоиться
camp|лагерь
can|банка
cancel|отменять
cancer|рак
candid|честный
candle|свеча
candy|конфеты
cane|трость
cannon|пушка
canopy|навес
canvas|холст
cap|кепка
capable|способный
capacity|емкость
capacity|способность
cape|мыс
capital|главный
captive|пленник
capture|захватить
carbohydrate|углевод
carbon|углерод
carcass|туша
cardboard|картон
care|забота
care|переживать
career|карьера
caress|ласкать
cargo|груз
carpenter|плотник
carpet|ковер
carriage|каретка
carrot|морковь
carry|носить
carry out|выполнить
cart|телега
cartoon|мультфильм
carve|вырезать
case|случай
case|ящик
cash|наличка
casket|шкатулка
cast |бросать
cast |отливать
casual|случайный
casualty|жертва
catch|расслышать
catch |ловить
catch on|становиться популярным
catch on|внезапно понять
catch up on|следить быть в курсе
catch up with|догнать
cater|обслуживать
catering|общественное питание
cathedral|собор
cattle|крупный рогатый скот
cause|причина
caution|предосторожность
cave|пещера
caviar|икра
cavity|полость
cease|прекращать
cedar|кедр
ceiling|потолок
celebrate|праздновать
celebrity|знаменитость
celestial|астрономический
cell|ячейка
cellar|подвал
cellular|сотовый
cemetery|кладбище
censorship|цензура
census|перепись
century|век
cereal|злак
certain|определенный
chain|цепь
chair|стул
chairman|председатель
chalk|мел
challenge|вызов
chamber|кабинет
chancellor|канцлер
change|сдача
chant|петь
chaos|хаос
chap|парень
chapel|часовня
chapter|глава
character|персонаж
charge|заряжать
charge|обвинять
charge|плата
charity|благотворительность
charm|обаяние
chart|схема
chase|погоня
chat|болтать
chatter|болтать
cheat|жульничать
cheat on|изменять
check|проверить
check in|вселиться
check into|лечь
check on|проверить
check out|посмотреть
check out|освободить номер
checkup|медосмотр
cheek|щека
cheer|аплодировать
cheer on|болеть
cheer up|взбодриться
cheerful|веселый
chef|шеф-повар
chemistry|химия
cherish|лелеять
chess|шахматы
chest|грудь
chest|сундук
chestnut|каштан
chew|жевать
chief|вождь
childhood|детство
chill|холод
chill out|расслабиться
chimney|дымовая труба
chin|подбородок
chip|щепка
choice|выбор
choir|хор
choke|задыхаться
chop|рубить
chop down|срубить
chop up|порезать
chord|аккорд
chore|скучная неприятная работа
chorus|припев
Christmas|рождество
chuck|бросать
chuckle|посмеиваться
chunk|кусок
church|церковь
cinema|кино
cinnamon|корица
circle|круг
circuit|схема
circumstance|обстоятельство
circus|цирк
cite|упоминать
citizen|гражданин
civic|гражданский
civil|гражданский
civilian|гражданский
claim|требовать
claim|утверждать
clam|моллюск
clamour|шум
clamp|зажимать
clap|хлопать в ладоши
clarify|прояснять
clash|столкновение
clasp|застежка
clause|пункт
claw|коготь
clay|глина
clean up|убрать
cleanse|очищать
clear|ясный
clear off|убраться вон
clear out|убирать
clear up|прояснить
cleave|раскалывать
clench|стиснуть
clergy|духовенство
clerical|канцелярский
clever|умный
click|щелкать
cliff|утес
climax|кульминация
climb|взбираться
cling |цепляться
clip|отсекать
clip|зажим
cloak|плащ
clockwise|по часовой стрелке
clog|загромождать
close down|закрыться
close in on|приближаться
closet|стенной шкаф
closure|закрытие
cloth|ткань
clothe|одевать
cloud|облако
clout|влияние
clove|гвоздика
clue|ключ
clump|комок
clumsy|неловкий
clutch|сцеплять
clutter|беспорядок
coach|автобус
coach|тренер
coal|уголь
coarse|грубый
coast|побережье
coaster|подставка
coat|покрывать
coat|пальто
coax|убедить
coconut|кокос
coerce|принуждать
coffin|гроб
coherent|согласованный
cohesion|единство
coil|катушка
coincide|совпасть
coincidence|совпадение
cold|простуда
collaborate|сотрудничать
collapse|обрушиться
collar|воротник
collect|собирать
collide|сталкиваться
colon|двоеточие
colonel|полковник
column|столб
comb|расческа
combat|бой
combine|соединять
come about|произойти
come across|встретить
come along|идти вместе
come along|продвигаться
come by|найти
come by|зайти
come down|сводиться
come from|быть из
come into|унаследовать
come off|выйти
come off|отвалиться
come on|включаться
come out|выступить
come out|выходить
come over|заходить
come through|пережить
come to|очнуться
come to|доходить до
come to life|оживать
come true|сбываться
come under|подвегрнуться
come up|произойти
come up|приближаться
come up to|подойти к
come up with|придумать
come with|прилагаться
comedian|комик
comfort|утешать
commemorate|отметить
commence|начинать
commend|высоко оценивать
commercial|реклама
commission|поручение
commit|совершить
commitment|приверженность
commitment|обязательство
commodity|товар
common|общий
common|обычный
commonplace|обычное дело
commonwealth|содружество
communicate|общаться
community|община
commute|ходить
compact|договор
compare|сравнить
comparison|сравнение
compartment|отсек
compassion|сочуствие
compatible|совместимый
compel|вынуждать
compete|соперничать
complain|жаловаться
complement|допонять
complement|набор
complete|завершить
complex|сложный
complicate|усложнять
comply|соблюдать
compose|составлять
compound|состав
comprehend|понять
comprehensive|исчерпывающий
compress|сжимать
comprise|состоять из
compulsory|принудительный
comrade|товарищ
conceal|скрывать
concede|уступить
conceive|помыслить
concept|понятие
concern|забота
conclude|заключать
concrete|бетон
concur|соглашаться
condemn|осуждать
condition|состояние
condition|условие
conduct|вести
cone|конус
confer|дать
confer|совещаться
confess|признаваться
confide|доверить
confident|уверенный
confine|ограничить
confirm|подтвердить
conform|соответствовать
confront|противостоять
confuse|путать
congestion|загруженность
congratulate|поздравлять
conjunction|соединение
connect|соединять
conquer|завоевать
conquest|завоевание
conscience|совесть
conscious|сознательный
consecutive|последующий по времени
consent|согласие
consequence|последствие
consequent|последующий
conserve|беречь
consider|рассматривать
consider|считать чем-либо
considerable|крупный
consist of|состоять
consistent|последовательный
console|утешать
conspicuous|заметный
conspire|сговариваться
constant|постоянный
constellation|созвездие
constitute|составлять
constrain|ограничивать
construct|соорудить
construction |стройка
consult|советоваться
consume|потреблять
contain|содержать
contaminate|загрязнять
contemplate|созерцать
contemporary|современный
contempt|презрение
contend|бороться
content|содержимое
content with|довольный
contest|соревнование
contingency|непредвиденные обстоятельства
continue|продолжить
contract|сокращаться
contradict|противоречить
contrary|противоположный
contribute|способствовать
controversy|спор
convene|созывать
convenient|удобный
conventional|стандартный
converge|сходиться
converse|разговаривать
convert|преобразовывать
convey|перевозить
convict|осужденный
conviction|убеждение
convince|убеждать
cookie|печенье
cool|прохладный
cool down|остыть
cooperate|сотрудничать
cope with|совладать
copper|медь
cord|веревка
core|ядро
cork|пробка
corn|кукуруза
corner|угол
corps|корпус
corpse|труп
correct|правильный
correlate|соотносить
correspond|соответствовать
corrupt|развращать
cost |стоить
cotton|хлопок
couch|диван
cough|кашель
council|совет
counsel|совет
count|считаться
count|считать
count on|рассчитывать на
counter|противостоять
counter|стойка
counterfeit|подделка
counterpart|аналог
countryside|сельская местность
county|графство
coup|переворот
couple|пара
courage|мужество
court|суд
court|двор
court|игровая площадка
courtesy|учтивость
courtyard|внутренний двор
cover|накрывать
coverage|освещение
covet|желать
coward|трус
co-worker|сотрудник
cozy|уютный
crack|трескаться
crackle|потрескивание
cradle|колыбель
craft|ремесло
cram|втискивать
cramp|судорога
crane|подъемный кран
crank|чудак
crap|дерьмо
crash|горохот
crate|ящик
crave|желать
crawl|ползать
crayon|цветной карандаш
creak|скрипеть
cream|крем
crease|складка
create|создавать
creature|существо
credential|удостоверение
credible|заслуживающий доверия
creed|вероисповедание
creek|ручей
creep|гад
creep |ползти
creepy|жуткий
crest|гребень
crew|команда
crib|раскладушка
crime|преступление
criminal|преступник
crimson|малиновый
cringe|съеживаться
cripple|калека
crisp|хрустящий
crook|сгибать
crop|урожай
cross|пересекать
cross out|вычеркнуть
crossroads|перекресток
crouch|присесть
crow|ворона
crowd|толпа
crown|корона
crucial|решающий
crude|сырой
cruel|жестокий
crumb|крошка
crumble|крошить
crumple|смять
crunch|хрустеть
crusade|крестовый поход
crush|раздавливать
crust|кора
cry out|закричать
cub|детеныш
cubicle|отсек
cucumber|огурец
cuddle|обнимать
cue|сигнал
cuisine|кухня
cup|чашка
cupboard|шкаф
curb|узда
curb|бордюр
cure|лечить
curious|любопытный
curl|скручивать
currency|валюта
current|текущий
current|ток
curriculum vitae|резюме
curse|проклятие
curtain|занавеска
curve|изгибать
cushion|подушка
custody|охрана
custom|заказной
custom|обычай
customer|клиент
customs|таможня
cut across|пересечь
cut down|урезать
cut off|отрезать
cute|привлекательный
dagger|кинжал
daily|ежедневно
dairy|молочные продукты
dam|плотина
damage|вред
damn|проклятый
damp|сырой
dangle|мотаться
dare|осмелиться
darling|дорогой
darn|штопать
dash|тире
dash|бросать
dash|разрушить
data|данные
database|база данных
date|свидание
daunt|пугать
dawn|рассвет
dawn on|осенить
day off|выходной
daze|ошеломить
dazzle|ослепить
dead end|тупик
deaf|глухой
deal|сделка
deal in|заниматься
deal with|иметь дело с
debate|обсуждать
debris|мусор
debt|долг
decade|десятилетие
decay|распад
deceased|покойный
deceive|обманывать
decent|приличный
deception|обман
decide|решить
decisive|решающий
deck|палуба
declare|объявлять
decline|отказаться
decline|снижаться
decorate|украшать
decrease|уменьшать
decree|постановление
dedicate|посвящать
deduct|вычитать
deed|дело
deem|считать
deep|глубокий
deer |олень
defeat|поражение
defence |защита
defend|защитить
deficient|недостаточный
define|определять
definite|определенный
deflect|отклонять
deft|ловкий
defy|пренебрегать
degree|степень
degree|градус
deity|божество
delay|задерживать
deliberate|обдуманный
delicate|тонкий
delicious|восхитительный
delight|восторг
delinquent|правонарушитель
deliver|доставлять
deliver|рожать
delusion|наваждение
demand|требовать
demand|спрос
demise|кончина
demolish|сносить
den|логово
denote|обозначать
denounce|осуждать
dense|густой
dent|вмятина
dental|зубной
deny|отрицать
depart|отправляться
department|отдел
depend|зависеть
dependent|зависимый
depict|изображать
deplete|истощать
deploy|развертывать
depot|хранилище
depress|угнетать
deprive|лишать
depth|глубина
deputy|депутат
derive|выводить
descend|спускаться
descend from|происходить от
describe|описать
desert|пустыня
desert|бросать
deserve|заслуживать
designate|обозначать
desire|желание
desk|письменный стол
desktop|настольный
desolate|пустынный
despair|отчаяние
desperate|отчаянный
despise|презирать
despite|несмотря на
destination|место назначения
destiny|судьба
destroy|разрушать
detach|отделить
detain|задерживать
detect|обнаружить
detention|задержание
deter|удерживать
deteriorate|ухудшать
determine|определить
determined|решителен
detriment|ущерб
devastate|опустошать
develop|развивать
deviate|отклоняться
devise|придумывать
devoid|лишенный
devote|посвятить
devour|пожирать
dial|набирать номер
diamond|бриллиант обычно алмаз
diary|дневник
dice |кубик
dictionary|словарь
die down|утихнуть
die out|вымереть
differ|отличаться
different|разный
difficulty|трудность
diffuse|рассеивать
dig |копать
dig up|откопать
digest|переваривать
digit|цифра
dignity|достоинство
diligent|усердный
dilute|разбавлять
dim|тусклый
dimension|измерение
diminish|уменьшаться
dine|ужинать
dip|окунать
dire|страшный
direct|прямой
direct|направлять
directory|справочник
disable|отключить
disabled|инвалид
disappoint|разочаровывать
disaster|бедствие
discard|отбросить
discern|различить
disciple|ученик
disclose|раскрывать
discount|скидка
discourage|отговорить
discourse|речь
discover|открыть
discreet|сдержанный
discrepancy|несоответствие
discrete|отдельный
discretion|благоразумие
discriminate|различать
discuss|обсуждать
disdain|пренебрегать
disease|болезнь
disgrace|бесчестие
disguise|маскировать
disgust|отвращение
dish|тарелка
dish|блюдо
disillusion|разочаровывать
dislocate|вывихнуть
dismantle|разобрать
dismay|испуг
dismiss|прогонять
dismiss|отклонить
disorder|беспорядок
disparity|неравенство
dispatch|отправлять
dispel|развеяться
dispense|распределять
dispense with|обойтись без
disperse|рассеиваться
displace|вытеснять
display|показ
dispose of|располагать
dispose of|избавиться
dispute|спор
disrupt|нарушить
dissent|несогласие
dissipate|рассеивать
dissolve|растворять
distant|отдаленный
distinct|четкий
distinguish|выделять
distort|искажать
distract|отвлекать
distress|несчастье
distribute|распределять
district|район
disturb|тревожить
ditch|ров
dive|нырять
diverge|расходиться
diverse|разнообразный
divert|отвлечь
divide|делить
divine|божественный
divorce|развод
dizzy|головокружительный
do about|сделать
do away with|покончить
do up|привести в порядок
do without|обойтись без
dock|причал
dodge|уворачиваться
dole|пособие по безработице
doll|кукла
domain|область
dome|купол
domestic|домашний
domestic|внутренний
donate|жертвовать
donkey|осел
doom|гибель
doorway|дверной проем
dope|наркотик
dormitory|общежитие
dot|точка
double|удваивать
doubt|сомневаться
dough|тесто
doughnut|пончик
downtown|центр города
downturn|спад
dozen|дюжина
draft|тяга
draft|проект
drag|тащить
drag on|тянуться долго
drain|слив
drastic|радикальный
draw |тянуть
draw up|составить
drawback|недостаток
drawer|выдвижной ящик
dread|страх
dream|сон
dream up|придумать
dress|одеваться
dress up|нарядиться
drift|дрейфовать
drill|сверло
drills|тренировка
drip|капля
drive |водить машину
drive |двигать
drive out|выгнать
drizzle|моросить
drop|падать
drop|капля
drop by|зайти
drop off|завезти
drop out of|бросить
drought|засуха
drown|тонуть
drug|лекарство
drum|барабан
dry|сухой
dry up|пересохнуть
dual|парный
dub|дублировать
dubious|сомнительный
duckling|утенок
dude|чувак
due|должный
due to|из-за
duke|герцог
dull|скучный
dumb|немой
dumb|тупой
dummy|манекен
dump|сваливать
dump|бросать
duo|дуэт
duplicate|дублировать
durable|прочный
duration|продолжительность
during|во время
dusk|смеркаться
dust|пыль
duty|обязанность
dwarf|карлик
dwell|обитать
dwell on|остановиться
dwindle|постепенно уменьшаться
dye|краска
eager|сильно желающий
early|рано
earn|зарабатывать
earnest|серьезный
earring|серьга
earth|Земля
earthquake |землетрясение
ease|легкость
east|восток
Easter|Пасха
eat out|есть не дома
eat up|съесть полностью
echo|эхо
eclipse|затмение
edge|край
edible|съедобный
edit|редактировать
educate|воспитывать
efficacy|результативность
efficient|оптимальный
effort|усилие
either|либо
either|тоже
either|любой из двух
eject|выталкивать
elaborate|разработать
elbow|локоть
elder|старший
elect|избирать
elevate|поднимать
elicit|добиться
eligible|имеющий право
eliminate|устранять
elk|лось
eloquent|красноречивый
elude|ускользнуть
embark on|начать
embarrass|смущать
embassy|посольство
embed|встроить
embody|олицетворять
embrace|обхватить
emerge|появляться
emergency|чрезвычайная ситуация
eminent|видный
emit|испускать
emperor|император
emphasis|акцент
empire|империя
employ|использовать
employ|нанимать на работу
empower|давать возможность
empty|пустой
enable|давать возможность
enact|вводить
enchant|околдовать
enclose|окружать
encompass|охватывать
encounter|встретиться
encourage|поддерживать
end up|заканчивать чем-либо
endanger|подвергать опасности
endeavor |стремиться
endorse|одобрять
endow|наделять
endure|выдерживать
enforce|внедрить
engage in|заниматься
engaged|помолвленный
engender|зарождать
engine|двигатель
enhance|повысить
enlarge|увеличить
enlighten|просветить
enlist|привлечь
enormous|огромный
enrich|обогащать
enrol |записать
ensemble|ансамбль
ensue|следовать
ensure|обеспечить
entail|влечь за собой
enter|войти
enterprise|предприятие
entertain|развлекать
entice|соблазнять
entire|весь
entitle|давать название
entitle|давать право
entity|сущность
entrepreneur|предприниматель
envelope|конверт
environment|среда
envision|воображать
envy|зависть
equal|равный
equation|уравнение
equip|оснащать
equity|равноправие
eradicate|уничтожить
erase|стирать
erect|воздвигнуть
erode|размывать
errand|поручение
error|ошибка
erupt|извергаться
escape|избежать
essence|сущность
essential|необходимый
establish|установить
esteem|уважать
estimate|примерно оценивать
eternal|вечный
evade|уклоняться
evaluate|дать оценку
evaporate|испаряться
eve|канун
even|ровный
event|событие
eventual|конечный
ever|когда-либо
evidence|доказательство
evident|очевидный
evil|злой
evoke|вызывать
evolve|развиваться
exact|точный
exaggerate|преувеличивать
examine|осмотреть
example|пример
excavate|рыть
exceed|превышать
excel|преуспеть
excellent|превосходный
except|кроме
excerpt|выдержка
excess|избыток
exchange|обмен
excite|волновать
exclaim|восклицать
exclude|исключать
excuse|оправдание
execute|исполнить
execute|казнить
exempt|освободить
exercise|упражнение
exert|приложить
exhale|выдыхать
exhaust|исчерпывать
exhaust|выхлопные газы
exhibit|выставлять
exile|ссылка
exist|существовать
exit|выход
expand|расширять
expanse|пространство
expect|ожидать
expel|высылать
expenditure|расходы
expense|расходы
experience|опыт
expertise|опыт
expire|истекать
explain|объяснять
explicit|явный
explode|взрываться
exploit|использовать
explore|изучать
expose|выставлять
express|выражать
exquisite|утонченный
extend|расширять
extent|степень
exterior|внешний
external|внешний
extinct|вымерший
extinguish|погасить
extort|вымогать
extra|дополнительный
extract|извлекать
extreme|крайний
exuberant|буйный
eyebrow|бровь
eyelid|веко
fable|басня
fabric|ткань
fabulous|невероятный
face|столкнуться
face up to|принять
facet|грань
facial|лицевой
facilitate|облегчать
facility|сооружение
facility|легкость
faction|группировка
factory|фабрика
faculty|дар
fade|увядать
fail|потерпеть неудачу
failure|неудача
faint|слабый
faint|обморок
fair|светлый
fair|справедливый
fairly|довольно
fairy|фея
faith|вера
fall|осень
fall apart|разваливаться
fall asleep|уснуть
fall back on|опереться
fall behind|отставать
fall for|вестись
fall for|влюбляться
fall in love with|влюбиться
fall out|ссориться
fall over|упасть
fall through|провалиться
false|ложный
falter|колебаться
fame|известность
familiar|знакомый
famine|голод
famous|знаменитый
fan|вентилятор
fancy|необычный
fancy|представлять
faraway|далекий
fare|плата за проезд
farewell|прощальный
farm|ферма
fascinate|очаровывать
fashion|мода
fashion|стиль
fasten|закрепить
fat|жир
fate|судьба
fatigue|усталость
faucet|кран
fault|недостаток
fault|вина
favor|благоприятствовать
favor |услуга
fear|страх
feasible|выполнимый
feast|праздник
feat|подвиг
feather|перо
feature|черта
fee|плата
feeble|слабый
feed |кормить
feed on|питаться
feedback|обратная связь
feel |трогать
feel for|сочувствовать
feel like|хотеть
fellow|парень
fellow|товарищ по чему-либо
felon|преступник
female|женский
feminine|женский
fence|забор
fend for |позаботиться о
fend off|защищаться
ferocious|свирепый
ferry|переправа
fertile|плодородный
fetch|сходить принести
fetus|плод
fever|лихорадка
fibre|волокно
fiction|вымысел
fiddle|скрипка
fidelity|верность
field|поле
fierce|свирепый
fight back|отбиваться
fight off|отбить
figure|полагать
figure out|понять
fill in|заполнить
fill in on|посвятить
fill up|наполнить целиком
film|снимать кино
filth|грязь
fin|плавник
find out|выяснить
fine|штраф
fine|тонкий
fine|хороший
fingertip|кончик пальца
fir|ель
firefighter|пожарник
fireplace|камин
firework|фейерверк
firm|твердый
fisherman|рыбак
fishing|рыбалка
fist|кулак
fit|приступ
fit |подходить
fit in with|вписаться
fix|исправить
fixture|крепление
flair|чутье
flake|слоиться
flakes|хлопья
flame|пламя
flank|бок
flap|створка
flare|вспышка
flash|вспышка
flashlight|фонарик
flat|плоский
flat|квартира
flatter|льстить
flavor|вкус
flaw|изъян
flea|блоха
flee |спасаться бегством
fleet|флот
fleeting|мимолетный
flesh|плоть
flex|сгибать
flick|короткое резкое движение
flick|фильм
flick through|просмотреть
flicker|мерцать
flight|полет
flight|бегство
flight attendant|бортпроводник
flinch|дернуться
fling |швырнуть
flip|переворачивать
float|плыть
flock|стадо
flood|потоп
flood in|наплыть
floor|пол
floor|этаж
flop|провал
flour|мука
flourish|процветать
flow|поток
flu|грипп
fluctuate|колебаться
fluent|беглый
fluffy|пушистый
fluid|жидкий
flurry|поток
flush|промывать
flush|румянец
flute|флейта
flutter|трепетать
fly|муха
foam|пена
focus|сосредоточить
foe|недруг
fog|туман
foil|расстаривать
foil|фольга
fold|сворачивать
folder|папка
foliage|листва
folk|люди
follow|следовать
folly|глупость
fond of|любящий
fool|дурак
fool around|придуриваться
footage|запись
footing|опора
footprint|след
for real|правда
for sure|наверняка
for the sake of|ради
forbid |запрещать
forcible|насильственный
forecast|прогноз
forehead|лоб
foreign|иностранный
foreman|мастер
foremost|передовой
foresee|предвидеть
forge|ковать
forge|подделывать
forgive |простить
fork|развилка
former|бывший
former|первый
formidable|внушительный
forth|дальше
forthcoming|предстоящий
fortify|укреплять
fortunate|удачный
fortune|состояние
fortune|счастье
fossil|ископаемое
foster|приемный
foster|способствовать
foul|гадкий
found|основать
foundation|фундамент
fountain|фонтан
foyer|фойе
fraction|доля
fracture|перелом
fragile|хрупкий
fragrant|душистый
frail|хилый
frame|рамка
framework|каркас
frank|откровенный
frantic|неистовый
fraud|обман
fray|драка
frayed|потрепанный
freak|урод
freak out|пугать
free|свободный
free up|высвободить
freeway|автострада
freeze |замораживать
freight|грузовой
frenzy|неистовство
frequent|частый
freshen up|освежить
fret|волновать
friction|трение
friendly|дружелюбный
fright|испуг
frighten off|отпугивать
fringe|край
frog|лягушка
front|перед
frontier|граница
frost|мороз
frown|хмуриться
fruitless|бесплодный
frustrate|расстраивать
fry|жарить
fuck with|дразнить
fuel|топливо
fugitive|беглец
fulfil|исполнить
fumble|щупать
fume|дым
fund|фонд
funeral|похороны
fungus|гриб
funnel|воронка
fur|мех
furnace|печь
furnish|предоставлять
furnish|обставлять
furniture|мебель
further|дальнейший
fury|ярость
fuse|плавиться
fuss|суетиться
futile|тщетный
future|будущий
fuzzy|пушистый
gain|получать
gait|походка
gala|праздник
gamble|азартная игра
gang|банда
gap|разрыв
garbage|мусор
garden|сад
garlic|чеснок
garment|предмет одежды
garnish|гарнир
gas|бензин
gasp|задыхаться
gates|ворота
gather|собирать
gauge|измерить
gaze|пристально глядеть
gear|механизм
geared to|направлен на
gem|драгоценный камень
gender|пол
gene|ген
general|общий
generation|поколение
generous|великодушный
gentle|мягкий
genuine|подлинный
germ|микроб
gesture|жест
get|становиться
get about|передвигаться
get ahead|преуспевать
get ahead of|обогнать
get along|ладить
get at|клонить
get away with|безнаказанно сделать
get back at|отомстить
get by|обойтись
get down|приступить
get in|прибывать
get lost|пропасть
get off|выходить
get off with|отделаться чем-либо
get on|быть
get out of|избежать
get over|пережить
get rid of|избавиться от
get stuck|застрять
get through|дозвониться
get together|собираться
get used to|привыкнуть
ghost|привидение
giant|гигантский
gift|подарок
giggle|хихикать
give a ride|подвезти
give away|раздавать
give away|выдать
give birth to|родить
give off|издавать
give out|раздать
give up|отказаться
give up|бросить
glacier|ледник
glamour|очарование
glance|взгляд
glare|яркий свет
glass|стекло
glasses|очки
glaze|глазурь
gleam|блеск
glide|скользить
glimpse|вид
glint|вспыхнуть
glitter|блеск
globe|мир
gloom|сумрак
glory|слава
gloss|глянец
glove|перчатка
glow|сияние
glue|клей
gnaw on|грызть
go about|заниматься
go against|противоречить
go ahead|взять
go along|поддерживать
go bad|испортиться
go down|быть принятым
go for|быть проданным за
go for|выбирать
go into|вдаваться
go off|сработать
go off|отключиться
go on|происходить
go on|продолжаться
go out|погаснуть
go over|просмотреть
go through|просмотреть
go together|сочетаться
go under|разориться
goal|цель
goat|козел
goddess|богиня
goods|товары
goof|балбес
gorgeous|шикарный
gospel|евангелие
gossip|слухи
govern|управлять
gown|платье
grab|схватить
grace|благодать
grade|оценка
grade|класс
gradual|постепенный
graduate|выпускник
grain|зерно
grand|большой
grant|давать
grape|виноград
graph|график
grapple|сцепиться
grasp|схватывать
grate|решетка
grateful|благодарный
gratify|удовлетворять
gratitude|благодарность
grave|могила
grave|серьезный
gravel|гравий
gravy|подливка
graze|пасти
grease|смазка
greed|жадность
greenhouse|теплица
greet|приветствовать
grid|сетка
grief|горе
grievance|обида
grieve|горевать
grim|мрачный
grin|ухмыляться
grind |молоть
grip|хватать
grit|крошка
grit|твердость
groan|стон
grocery|продуктовый
groom|жених
groove|канавка
grope|щупать
gross|валовой
gross|грубый
grove|лесок
grow |становиться
grow |расти
grow up|вырастать
growl|рычать
grudge|обида
grumble|ворчать
grunt|хрюкать
guard|сторожить
guess|угадывать
guest|гость
guide|вести
guideline|общее правило
guilt|вина
guise|облик
gulf|разрыв
gulf|залив
gulp|большой глоток
gum|жвачка
gun|огнестрельное оружие
gust|порыв
gut|кишка
gutter|желоб
gym|спортзал
Gypsy|цыган
habit|привычка
habitat|среда
hack|рубить
hail|град
hail|окликнуть
hail|приветствовать
haircut|стрижка
hall|зал
hallmark|характерная черта
halt|останавливаться
halve|делить пополам
ham|ветчина
hammer|молоток
hamper|затруднять
hand down|передать
hand in|сдать
hand over|передать
handbook|руководство
handcuffs|наручники
handful|горсть
handicap|помеха
handkerchief|носовой платок
handle|рукоятка
handle|управляться
handsome|красивый
handwriting|почерк
handy|удобный
hang |висеть
hang around|зависать
hang out|тусоваться где-то
hangover|похмелье
happen|случиться
harass|тревожить
harbor |гавань
hardly|едва
hardware|аппаратные средства
hardy|выносливый
harm|вред
harness|запрягать
harp|арфа
harsh|резкий
harvest|урожай
hassle|трудность
haste|спешка
hat|шляпа
hatch|люк
hatred|ненависть
haul|тащить
haunt|являться
hawk|ястреб
hay|сено
hazard|опасность
haze|дымка
head for|направляться
head off|выйти
headlight|передняя фара
headline|заголовок
headquarters|штаб-квартира
heal|лечить
health|здоровье
healthcare|здравоохранение
heap|куча
heat|тепло
heat up|разогреть
heave|вздыматься
heaven|небеса
hebrew|еврейский
hectic|беспокойный
hedge|живая изгородь
heed|прислушиваться
heel|каблук
hefty|большой и тяжелый
height|высота
heir|наследник
helicopter|вертолет
helm|руль
helmet |шлем
help out|выручить
helpful|полезный
helpless|беспомощный
hemisphere|полушарие
hen|курица
hence|отсюда
herald|возвестить
herb|трава
herd|стадо
heritage|наследие
hero|герой
hesitate|колебаться
hide |скрывать
hideous|отвратительный
hierarchy|иерархия
high-end|высококлассный
highlight|выделить
highway|шоссе
hijack|угонять
hike|поход
hilarious|веселый
hill|холм
hinder|мешать
hinge|петля
hint|намек
hip|таз
hire|нанимать
hiss|шипеть
hit |ударить
hit |попасть
hit back|отыграться
hit on|клеить
hitch|заминка
hoard|копить
hobble|прихрамывать
hog|большой свин
hoist|поднимать
hold back|сдерживать
hold on|оставаться на линии
hold on|держаться
hold up|задержать
hole|дыра
holler|крикнуть
hollow|полый
holy|святой
homeland|родина
homicide|убийство
honest|честный
honey|мед
honor |честь
hood|капот
hood|капюшон
hoof|копыто
hook|крюк
hook up|потрахаться
hook up|подключить
hoop|обруч
hop|прыгать
hopeful|внушающий надежды
horizon|горизонт
horn|рог
horrible|ужасный
horrify|ужасать
horseback|верхом
hose|шланг
hospitality|гостеприимство
host|хозяин
host|множество
hostage|заложник
hostile|враждебный
hound|охотничья собака
household|домашний
housewife|домохозяйка
hover|зависнуть
however|однако
howl|выть
huddle|столпиться
hue|цвет
hug|объятие
huge|огромный
hull|корпус
hum|гудеть
human|человек
humble|скромный
humid|влажный
humiliate|унижать
hump|горб
hunch|горб
hunch|догадка
hunger|голод
hunk|ломоть
hurdle|препятствие
hurl|метать
hurricane|ураган
hurry|спешить
hurt |причинять боль
hush|молчать
hustle|толкаться
hustle|нечестно добыть
hut|хижина
hydrogen|водород
hypocrite|лицемер
ID|удостоверение личности
idle|праздный
ignite|воспламеняться
ignorant|невежественный
ill|больной
ill|дурной
illicit|незаконный
illuminate|освещать
image|изображение
imagine|вообразить
immediate|немедленный
immense|огромный
immerse|погружаться
imminent|неизбежный
impact|воздействие
impair|ухудшать
impede|затруднять
impending|предстоящий
imperative|обязательный
implement|осуществлять
implicate|указать на причастность
implicit|подразумеваемый
imply|подразумевать
importance|важность
impose|навязывать
imposing|внушительный
impress|впечатлить
imprint|отпечаток
improve|улучшить
in a row|подряд
in advance|заранее
in charge|во главе
in spite of|несмотря на
incentive|стимул
inch|дюйм
incidence|частотность
incline|наклонять
include|включать
income|доход
incoming|входящий
incorporate|вобрать
increase|увеличивать
incredible|невероятный
incumbent|возложенный
incur|навлечь
indeed|в самом деле
indicate|указывать
indifferent|безразличный
indigenous|коренной
induce|вызывать
indulge|баловать
industry|отрасль
inevitable|неизбежный
inexplicable|необъяснимый
infamous|печально известный
infant|ребенок
infantry|пехота
infect|заражать
infer|делать вывод
inferior|низший
infinite|бесконечный
inflame|разжигать
inflate|надувать
inflict|причинять
influence|влиять
infuse|вливать
ingenious|изобретательный
inhabit|населять
inhale|вдыхать
inherent|свойственный
inherit|унаследовать
inhibit|препятствовать
initial|первоначальный
inject|впрыскивать
injure|ранить
ink|чернила
inland|внутренний
inmate|обитатель
inn|гостиница
inner|внутренний
innocent|невинный
input|вход
inquire|узнавать
insect|насекомое
insert|вставить
inside|внутри
inside out|наизнанку
insight|понимание
insist|настаивать
inspect|проверять
inspire|вдохновить
install|устанавливать
instance|пример
instant|мгновенние
instead|вместо
insulate|изолировать
insult|оскорбление
insure|страховать
insurgent|повстанец
intact|неповрежденный
intake|потребление
integral|составной
integrity|честность
integrity|целостность
intelligence|разведка
intelligent|умный
intelligible|вразумительный
intend|намереваться
intended|предназначенный
interact|взаимодействовать
intercept|перехватить
intercourse|отношения
interfere|вмешиваться
interim|промежуточный
interior|внутренность
intermediate|промежуточный
intern|стажер
internal|внутренний
interpret|истолковывать
interpreter|переводчик
interrogate|допрашивать
interrupt|прерывать
intersect|пересекаться
intervene|вмешиваться
intestine|кишечник
intimate|близкий
intimidate|запугивать
intricate|сложный
intrinsic|присущий
introduce|представить
introduce|ввести
intrude on|вторгаться
invade|вторгаться
invent|изобретать
inventory|опись
invert|переворачивать
investigate|расследовать
invite|приглашать
invoke|взывать
involve|вовлекать
involve|содержать в себе
inward|внутрь
iron|утюг
iron|железо
irritate|раздражать
island|остров
issue|издать
issue|вопрос
itch|зуд
item|пункт
ivory|слоновая кость
ivy|плющ
jab|ударять
jacket|куртка
jail|тюрьма
janitor|дворник
jar|банка
jaw|челюсть
jealous|ревнивый
jelly|желе
jeopardy|опасность
jerk|дергать
jerk|придурок
jet|струя
jet|самолет
Jew|еврей
jewel|драгоценности
jingle|звенеть
jog|бегать трусцой
join|присоединить
joint|сустав
joint|совместный
jolly|веселый
jolt|толчок
journalism|журналистика
journey|путешествие
joy|радость
judge|судья
judicial|судебная
jug|кувшин
jumble|перемешивать
jump at|ухватиться
jump in|вмешаться
jumper|джемпер
junction|стык
junior|младший
junk|барахло
junkie|наркоман
jury|жюри
just|справедливый
justice|правосудие
justify|оправдывать
jut|выступать
keen|острый
keep away|держать
keep off|избегать
keep on|продолжать делать
keep out of|не влезать
keep up|успевать
kernel|ядро
kettle|чайник
kick|пинать
kick around|обсудить
kick back|расслабиться
kid|шутить
kid|ребенок
kidnap|похищать
kidney|почка
kin |родственник
kind|добрый
kind|тип
kindergarten|детский сад
kit|комплект
kite|коршун
kitten|котенок
knack|умение
knee|колено
kneel|стать на колени
knight|рыцарь
knit|вязать
knob|ручка
knock|стучать
knock down|снести
knock out|вырубить
knock together|слепить
knot|узел
knowledge|знания
label|метка
labour|труд
lace|шнурок
lack|недостаток
lad|парень
ladder|лестница
laden|груженный
lag|запаздывание
lamb|ягненок
lame|хромой
lament|оплакивать
land|приземляться
landlord|арендодатель
landmark|ориентир
landscape|пейзаж
lane|полоса дороги
lantern|фонарь
lap|колени
lapse|упущение
lapse|промежуток времени
laptop|ноутбук
large|большой
lash |ресница
lash out|нападать
last|длиться
latch|защелка
late|поздний
late|покойный
lateral|боковой
latter|последний
laugh|смеяться
laughter|смех
launch|начать
laundry|прачечная
lavish|щедрый
law|закон
lawn|газон
lawsuit|тяжба
lay |класть
lay down|установить
lay off|уволить
lay out|выложить
layer|слой
layout|макет
lazy|ленивый
lead|вести
lead up to|предшествовать
leaf |лист
leak|утечка
lean|худой
lean against|опереться
lean over|наклониться над
leap|прыгать
lease|сдавать в аренду
leash|привязь
leather|кожаный
leave |уйти
leave behind|оставить
ledge|уступ
leek|лук-порей
leftover|остаток
leg|нога
legacy|наследие
legal|законный
legislation|законодательство
legitimate|законный
leisure|досуг
lend |давать в долг
length|длина
lens|линза
lessen|уменьшать
lest|чтобы не
let in on|посвящать
let off|отпустить
let smb down|подвести
let smb in|впустить
let up|прекратиться
letter|письмо
lettuce|салат
level|уровень
lever|рычаг
liable|подлежащий
liaison|связь
liberate|освобождать
liberty|свобода
library|библиотека
licence |разрешение
lick|лизать
lid|крышка
lie|лгать
lie |лежать
lifelong|пожизненный
lift|поднимать
light |зажигать
light up|осветить
lightning|молния
like|как
like that|так
likely|вероятно
likewise|также
limb|конечность
limit|ограничивать
limp|хромать
line|строка
line|линия
line up|встать в очередь
lineage|родословная
linen|белье
linen|льняная ткань
lineup|расстановка
linger|задерживаться
link|связь
lip|губа
lipstick|губная помада
liquid|жидкость
list|список
listen in on|подслушивать
literal|буквальный
literary|литературный
literate|грамотность
litter|мусор
live up to|соответствовать
livelihood|средства к существованию
liven up|оживить
liver|печень
livestock|скот
lizard|ящерица
load|грузить
loaf|буханка
loan|заем
loathe|ненавидеть
lobby|вестибюль
lobster|омар
local|местный
locate|определить местоположение
lock|замок
lock up|посадить в тюрьму
locker|ящик
locus|местоположение
lodge|домик
lodge|подавать
loft|чердак
log|бревно
lone|одинокий
long ago|давно
long for|желать
longevity|долговечность
look|выглядеть
look after|присматривать
look around|посмотреть
look at|рассмотреть
look for|искать
look forward|ожидать
look into|посмотреть
look out|смотреть
look smb up|найти
look up|улучшаться
look up to|уважать
loom|маячить
loop|петля
loose|свободный
loot|грабить
lord|господин
loss|потеря
lot|жребий
loud|громкий
lounge|гостиная
lounge|расслабляться
lousy|паршивый
lovely|чудесный
lower|нижний
loyal|верный
lucrative|прибыльный
ludicrous|нелепый
luggage|багаж
lumber|пиломатериалы
lump|кусок
lunar|лунный
luncheon|завтрак
lung|легкое
lurch|крениться
lure|приманка
lurk|таиться
lush|пышный
lust|вожделение
luxury|роскошь
lyrics|текст песни
magazine|журнал
magician|волшебник
magnificent|великолепный
magnify|увеличивать
magnitude|величина
maid|служанка
maiden|дева
mainland|материк
maintain|поддерживать
majesty|величие
major|главный
make fun of|смеяться
make into|переделать в
make of|извлечь
make out|разобрать
make out|целоваться
make sure|убедиться
make up|выдумать
make up|помириться
make up for|компенсировать
makeup|макияж
male|мужской
mall|торговый центр
mammal|млекопитающее
mammoth|мамонт
manage|справляться
mandatory|обязательный
manifest|проявить
mankind|человечество
mansion|особняк
mantle|мантия
manual|руководство
manual|ручной
manufacture|производить
manure|навоз
map out|запланировать
maple|клен
marble|мрамор
margin|край
margin|маржа
marine|морской
marital|супружеский
maritime|морской
mark|метка
mark down|снижать ценник
marry|жениться
marsh|болото
martial|боевой
martyr|мученик
marvel|диво
mash|разминать
massacre|резня
master|хозяин
master|овладеть
masterpiece|шедевр
mat|коврик
match|соответствие
match|спичка
mate|товарищ
maternal|материнский
matter|вещество
matter|дело
matter|иметь значение
mature|зрелый
may|пусть
mayor|мэр
maze|лабиринт
meadow|луг
meager|скудный
meal|еда
mean|неважный
mean |иметь в виду
mean |означать
mean |предназначать
means|средство
meantime|тем временем
meanwhile|тем временем
measure|мера
measure|измерять
mediate|посредничать
medicine|лекарство
medieval|средневековый
mediocre|посредственный
meditate|обдумывать
medium|средство
meet |встретить
melon|дыня
melt|таять
member|член
memoirs|мемуары
memories|воспоминания
memory|память
menace|угроза
mend|чинить
mental|умственный
mention|упоминать
mentor|наставник
merchandise|товар
merchant|торговец
mercury|ртуть
mercy|милость
mere|всего лишь
merge|соединять
merit|заслуга
merry|веселый
mesh|сетка
mess|беспорядок
mess up|испортить
mess with|возиться
metropolitan|столичный
mid|середина
middle|середина
midnight|полночь
midst|середина
midwife|акушерка
might|мощь
mild|мягкий
mileage|пробег
military|военный
mill|мельница
millennium|тысячелетие
mimic|передразнивать
mince|фарш
mind|возражать
mindful|внимательный
mine|мина
mine|шахта
mingle|смешиваться
minor|второстепенный
minor|несовершеннолетний
mint|мята
miracle|чудо
mischief|вред
miserable|несчастный
misery|нищета
misery|несчастье
miss|скучать
miss|пропускать
missile|ракета
missing|пропавший
mist|туман
mistake|ошибка
mistake for|принимать за
mistress|госпожа
mistress|любовница
mitigate|смягчить
mix up|перепутать
mixture|смесь
moan|стонать
mob|толпа
mock|издеваться
mode|режим
moderate|умеренный
modest|скромный
modify|видоизменять
moist|влажный
mold |плесень
mold |форма
mole|крот
mole|родинка
molest|приставать
monastery|монастырь
monetary|валютный
monk|монах
mood|настроение
moose|лось
mop|швабра
moreover|более того
moron|дебил
mortal|смертельный
mortgage|ипотека
mosque|мечеть
mosquito|комар
moss|мох
mostly|в основном
moth|мотылек
motion|движение
motto|девиз
mound|насыпь
mount|монтировать
mount|подниматься
mount|гора
mountain|гора
mourn|скорбеть
move|переезжать
move out|съехать
move over|подвинуться
movie|кино
mow|косить
muck|грязь
mud|грязь
mug|кружка
multiple|множественный
multiply|умножать
multitude|множество
mumble|бормотать
mural|стенная роспись
murder|убийство
murky|мутный
murmur|шум
muscle|мышца
mushroom|гриб
Muslim|мусульманин
mustache |усы
mustard|горчица
muster|собрать
mute|беззвучный
mutter|бормотать
mutual|взаимный
muzzle|морда
mystery|тайна
nail|гвоздь
nail|ноготь
naked|голый
name after|назвать в честь
nanny|няня
nap|вздремнуть
napkin|салфетка
narrate|повествовать
narrow|узкий
nasty|противный
native|родной
native|местный
natural|естественный
naughty|непослушный
nausea|тошнота
navigate|ориентироваться
navy|военно-морской флот
neat|аккуратный
necessary|необходимый
neck|шея
necklace|ожерелье
needle|игла
neglect|пренебрегать
negligent|небрежный
negotiate|вести переговоры
neighbour|сосед
neither|ни один из двух
neither|тоже не
nephew|племянник
nerd|ботан
nerve|смелость
nest|гнездо
net|чистый
network|сеть
never|так и не
nevertheless|тем не менее
newcomer|новичок
newspaper|газета
nibble on|покусывать
niche|ниша
niece|племянница
nightmare|кошмар
nipple|сосок
nitrogen|азот
no matter|неважно
noble|благородный
nod|кивать
noise|шум
nominate|выдвигать
none|никакой
nonetheless|тем не менее
noodles|лапша
noon|полдень
north|север
nose around|рыскать
nostril|ноздря
notch|выемка
note|заметка
notice|заметить
notify|известить
notion|понятие
notorious|известный
notwithstanding|несмотря на
noun|существительное
nourish|питать
novel|роман
novelty|новинка
nuclear|ядерный
nude|обнаженный
nudge|подталкивать
nuisance|неприятность
numb|онемелый
numeric |числовой
numerous|многочисленные
nun|монахиня
nurse|медсестра
nurture|растить
nut|орех
nutrient|питательный
nutrition|питание
nuts|чокнутый
oak|дуб
oath|клятва
oats|овес
obedience|покорность
obese|страдающий ожирением
obey|подчиняться
object|возражать
objective|цель
oblige|обязывать
oblique|косой
obscene|непристойный
obscure|неясный
observe|наблюдать
obsess|овладеть
obsolete|устарелый
obstacle|препятствие
obstruct|препятствовать
obtain|получить
obvious|очевидный
occasion|случай
occupation|профессия
occupy|занимать
occur|случиться
occur to|прийти в голову
odd|необычный
odds|шансы
odor |запах
offence|обида
offence |преступление
offend|обидеть
offer|предлагать
officer|служащий
offset|смещение
offspring|отпрыск
oil|масло
oil|нефть
ominous|зловещий
omit|пропускать
on account of|в связи
on behalf of|от имени
on foot|пешком
on purpose|нарочно
on the contrary|наоборот
once|однажды
ongoing|происходящий
onion|лук
onset|начало
onward |далее
opaque|непрозрачный
opening|отверстие
operate|управлять
opinion|мнение
opportunity|возможность
oppose|противостоять
opposite|противоположный
oppress|угнетать
opt for|выбирать из вариантов
option|выбор
oral|устный
orchard|фруктовый сад
order|порядок
order|заказ
order|приказ
ordinary|обычный
oriental|восточный
origin|происхождение
original|первоначальный
orphan|сирота
ostensibly|по видимости
otherwise|иначе
ought|должен
ounce|унция
out loud|вслух
outcome|результат
outdated|устаревший
outdoor |на улице
outer|внешний
outfit|наряд
outgoing|уходящий
outing|прогулка
outlaw|преступник
outlet|выход
outline|контур
outlook|перспектива
outnumber|превосходить численно
output|выпуск
outrage|произвол
outright|прямой
outset|начало
outskirts|окраина
outstanding|выдающийся
outstanding|неоплаченный
outweigh|перевешивать
oven|печь
over|заново
overall|общий
overcome|преодолеть
overflow|переполняться
overhead|над головой
overhear|подслушать
overlap|перекрываться
overlook|не заметить
overnight|ночной
override|перекрывать
overseas|за рубежом
oversee|контролировать
oversight|надзор
overt|явный
overtake|обгонять
overthrow|свергнуть
overtime|сверхурочная работа
overturn|опрокинуть
overview|обзор
overwhelm|завалить
owe|задолжать
owe|быть обязанным
owl|сова
own|владеть
oxygen|кислород
oyster|устрица
pace|шаг
pack|пачка
pack|упаковывать
pad|подушечка пальца
pad|блокнот
pad|панель
paddle|грести
pagan|язычник
pain|боль
pair|пара
pal|приятель
palace|дворец
pale|бледный
palm|ладонь
pan|сковорода
pancake|блин
pant|пыхтеть
pants|штаны
paper|бумага
paperwork|оформление бумаг
paragraph|абзац
parcel|посылка
pardon|извинять
parlor|приемная
parrot|попугай
parsley|петрушка
part|роль
part|часть
participate|участвовать
particle|частица
particular|частный
partisan|сторонник
partition|раздел
part-time|неполная занятость
pass|пройти
pass away|умереть
pass by|проходить мимо
pass off as|сойти
pass out|вырубиться
pass smth on|отдать
pass up|не воспользоваться шансом
passage|проход
passenger|пассажир
passion|страсть
past|мимо
past|прошлый
pastime|времяпрепровождение
pastry|выпечка
pasture|пастбище
pat|похлопать
patch|заплатка
path|путь
pathetic|жалкий
patient|терпеливый
patio|внутренний дворик
patrol|патруль
patron|покровитель
pattern|шаблон
pause|приостанавливать
pave|вымостить
paw|лапа
pay back|вернуть деньги
pay off|расплатиться
pay out|выплатить
payment|оплата
pea|горошина
peaceful|мирный
peacekeeper|миротворец
peach|персик
peanut|арахис
pear|груша
pearl|жемчуг
peasant|крестьянин
pebble|морской камень
peck|клевать
peculiar|своеобразный
peddle|торговать вразнос
pedestrian|пешеход
pee|писать
peek|вгзлянуть
peel|кожура
peer|ровня
peer|вглядываться
peg|колышек
penalty|наказание
pending|в ожидании
penetrate|проникать
peninsula|полуостров
pepper|перец
perceive|воспринимать
perception|восприятие
perennial|многолетний
perfect|совершенный
perform|выполнить
perhaps|возможно
peril|опасность
period|точка
perish|погибать
perk|привилегия
perk up|воспрянуть
permanent|постоянный
permit|разрешать
perpetual|вечный
perplex|смутить
persecute|преследовать
persist|сохраниться
persist|упорствовать
personnel|персонал
persuade|убеждать
pervasive|расширяющийся
pervert|извращать
pest|паразит
pet|домашний питомец
petal|лепесток
petroleum|нефть
petty|мелкий
phony|фальшивый
physician|врач
pick|подбирать
pick on|дразнить
pick out|выбрать
pick up|прибрать
pick up|подобрать
pickle|мариновать
pie|пирог
piece|предмет
pier|пристань
pierce|проколоть
pigeon|голубь
pile|куча
pile up|сложить
pill|пилюля
pillar|столб
pillow|подушка
pin|булавка
pinch|зажать
pine|сосна
pineapple|ананас
pipe|трубка
pipe|труба
piss|писать
piss about|страдать херней
piss off|бесить
pit|яма
pitch|подавать
pitch|ставить
pity|жалость
pivot|стержень
placement|размещение
placid|тихий
plague|чума
plain|ясный
plain|ровный
plain|простой
plane|самолет
plank|доска
plant|растение
plant|завод
plaque|бляшка
plaster|штукатурка
plate|плита
plausible|правдоподобный
playground|детская площадка
plea|просьба
please|радовать
pleasure|удовольствие
pledge|залог
pledge|обещание
plenty|множество
plight|тяжелое положение
plot|план
plot|сюжет
plow|пахать
pluck|сорвать
plug|штепсель
plug in|включать
plum|слива
plumbing|водопровод
plump|пухлый
plunge|окунуться
plural|множественное число
pocket|карман
point|смысл
point|точка
point|очко
point|острие
point|пункт
point out|указать
poise|равновесие
poison|яд
poke|совать
poke out|высовывать
pole|полюс
pole|шест
policy|политика
polish|шлифовать
polite|вежливый
poll|опрос
pollute|загрязнять
pond|пруд
ponder|обдумывать
pool|бассейн
poor|бедный
pope|папа римский
population|население
porcelain|фарфор
porch|крыльцо
pork|свинина
portable|портативный
porter|носильщик
portray|изображать
possess|обладать
possible|возможный
post|почта
postpone|отложить
posture|поза
pot|горшок
potato|картофель
potent|мощный
pouch|сумочка
poultry|домашняя птица
pound|фунт
pound|долбить
pour|лить
pour in |хлынуть
poverty|бедность
powder|порошок
powerful|мощный
practice|практика
prairie|степь
praise|хвалить
pray|молиться
preach|проповедовать
precarious|ненадежный
precaution|предосторожность
precede|предшествовать
precious|драгоценный
precise|точный
preclude|исключить
predator|хищник
predecessor|предшественник
predict|предсказывать
predominant|преобладающий
prefer|предпочитать
pregnant|беременная
prejudice|предубеждение
preliminary|предварительный
premature|преждевременный
premise|предпосылка
premises|помещение
preoccupy|занимать внимание
prepare|приготовить
prescribe|предписывать
present|настоящее
present|присутствующий
preserve|сохранять
preside|председательствовать
press|нажимать
presume|предполагать
pretend|притворяться
pretext|повод
pretty|довольно-таки
pretty|приятный
prevail|преобладать
prevent|предотвращать
prevent smb from|мешать
previous|предшествующий
prey|добыча
prick|колоть
pride|гордость
priest|жрец
primary|первичный
prime|важный
primitive|первобытный
principal|главный
prior|предварительный
prison|тюрьма
pristine|нетронутый
privacy|частная жизнь
private|частный
probable|вероятный
probe|исследовать
probe|датчик
procedure|процедура
proceed|следовать
process|обработать
proclaim|провозглашать
procure|достать
prod|ткнуть
produce|производить
proficient|опытный
profit|польза
profound|глубокий
prohibit|запрещать
prolong|продлить
prominent|выдающийся
promise|обещать
promote|поощрять
prompt|побуждать
prompt|быстрый
prone|склонный
pronounce|произносить
proof|доказательство
prop|подпирать
propagate|размножать
propel|двигать
proper|правильный
property|собственность
prophet|пророк
proponent|сторонник
propose|предлагать
prosecute|вести
prosecute|преследовать
prospect|перспектива
prosper|процветать
protect|защищать
proud|гордый
prove|доказывать
proverb|пословица
provide|обеспечивать
provided|при условии
provisional|предварительный
proximity|близость
prudent|разумный
pry|любопытствовать
publish|публиковать
puddle|лужа
puff|дуновение
pull back|отступить
pull off|справиться
pull over|притормозить ненадолго
pull through|выжить
pump|насос
pumpkin|тыква
punch|удар
punish|наказывать
pupil|зрачок
puppet|кукла
puppy|щенок
purchase|покупка
pure|чистый
purge|чистка
purple|пурпурный
purpose|цель
purse|кошелек
pursue|преследовать
pursuit|преследование
put aside|отложить
put away|посадить в тюрьму
put in|вложить
put off|отвратить
put off|откладывать
put on|надеть
put on|провести
put out|потушить
put out|обременять
put smb down|подавлять
put smth down to|объяснить
put through|подвергнуть
put together|собирать
put up|устроить
put up with|принимать
puzzle|озадачить
quaint|причудливый
quality|качество
quantity|количество
quarrel|ссора
quarry|карьер
quarter|четверть
queer|странный
query|запрос
quest|поиск
question|подвергать сомнению
questionnaire|анкета
queue|очередь
quiet|тихий
quilt|одеяло
quit |бросить
quite|вполне
quiz|викторина
quote|цитировать
rabbit|кролик
race|раса
race|гонка
rack|стеллаж
radiate|излучать
raft|плот
rag|тряпка
rage|ярость
raid|набег
rail|рельс
railway|железная дорога
rainbow|радуга
raise|растить
raise|поднять
raisin|изюм
rake|грабли
rally|собраться
rally|оживать
ram|баран
ramble|бродить
ramp|скат
random|выбранный наугад
range|диапазон
rank|ранг
ransom|выкуп
rape|насиловать
rapid|быстрый
rare|редкий
rash|опрометчивый
raspberry|малина
rate|курс
rate|показатель
rather|скорее
ratio|соотношение
rationale|основание
rattle|греметь
ravage|разорить
raw|сырой
ray|луч
razor|бритва
reach|достичь
reach out|потянуться
read out|огласить
read up on|изучить вопрос
real estate|недвижимость
realize|понимать
realm|царство
reap|пожинать
rear|задний
reason|разум
reason|причина
rebel|восставать
rebound|отскочить
recall|вспоминать
recede|убывать
receipt|квитанция
receipt|получение
receive|получить
recent|недавний
reception|прием
recess|перерыв
recess|выемка
recipe|рецепт
recipient|получатель
reciprocal|взаимный
recite|декламировать
reckless|опрометчивый
reckon|считать
recognize|узнавать
recollection|воспоминание
reconcile|примириться
record|запись
recount|пересказать
recover|восстановиться
recreation|отдых и развлечения
recruit|набирать
rectangle|прямоугольник
recur|повторяться
recycle|перерабатывать
redeem|выкупить
reduce|снижать
redundant|избыточный
reed|тростник
reel|катушка
refer|сослаться
refine|очищать
reflect|отражать
refrain|воздерживаться
refresh|обновлять
refrigerator|холодильник
refuge|убежище
refugee|беженец
refund|возврат
refuse|отказаться
refute|опровергать
regain|восстановить
regard|внимание
regard|считать
regiment|полк
register|касса
regret|сожалеть
regular|обычный
rehearse|репетировать
reign|царствовать
rein|сдерживать
reinforce|усилить
reject|отвергать
rejoice|радоваться
relate|относиться
relative|родственник
relative|относительный
relay|передавать
release|отпускать
relentless|настойчивый
relevant|уместный
relief|облегчение
relieve|облегчить
relish|наслаждаться
reluctant|неохотный
rely|полагаться
remain|оставаться
remainder|оставшаяся часть
remains|остатки
remark|замечать
remedy|средство
remind|напомнить
reminiscent|напоминающий
remnant|остаток
remorse|раскаяние
remote|отдаленный
remove|убрать
render|делать
render|воздавать
renew|возобновлять
renovate|ремонтировать
renown|известность
rent|аренда
repair|ремонт
repay|отплатить
repeal|отменить
repel|отталкивать
replace|заменить
replicate|воспроизвести
reply|ответ
report|доклад
represent|представлять
repress|подавлять
reproduce|воспроизводить
request|запрос
require|требовать
rescue|спасать
research|исследование
resemble|походить
resent|огорчаться
reserve|запас
reserve|бронировать
reserved|скрытный
reside|проживать
residue|остаток
resign|отказываться
resilient|стойкий
resist|сопротивляться
resolute|решительный
resolve|решиться
resolve|разрешить
resort|курорт
resort to|прибегать к
respective|соответственный
respond|отвечать
response|ответ
responsible|ответственный
rest|остаток
rest|отдых
rest|покоиться
restore|восстанавливать
restrain|ограничивать
restrict|ограничивать
result in|привести к
resume|возобновить
resurrect|воскрешать
retail|розничная продажа
retain|сохранять
retaliate|отплатить
retarded|умственно отсталый
retention|удержание
retire|уходить в отставку
retract|втягивать
retreat|отступать
retrieve|извлечь
retrospect|взгляд в прошлое
return|возвращаться
reveal|раскрыть
revenge|месть
revenue|доход
revere|почитать
reverse|обратный
review|обзор
revise|пересматривать
revive|возрождать
revolt|восстание
revolve|вращаться
reward|награда
rhyme|рифма
rib|ребро
ribbon|лента
rice|рис
rich|богатый
rid|освобождать
riddle|загадка
ride|ездить
ridge|хребет
ridicule|осмеяние
ridiculous|смешной
rifle|винтовка
rift|разрыв
rig|установка
right away|немедленно
righteous|праведный
rigid|жесткий
rigorous|строгий
rim|край
ring |звонить
rinse|полоскать
riot|бунт
rip|рвать
rip off|обмануть
ripe|созревший
ripple|рябь
rise |подниматься
rite|церемония
rival|соперничающий
rivet|заклепка
roadside|обочина
roadway|проезжая часть
roam|бродить
roar|рев
roast|жарить
rob|грабить
robe|халат
robust|крепкий
rock|камень
rock|качать
rod|стержень
rodent|грызун
rogue|жулик
roll|рулон
roll|катиться
roll up|свернуть
roof|крыша
room|место
root|корень
root out|искоренить
rope|веревка
rope in |втянуть в занятие
rot|гнить
rotate|сменять
rotate|вращать
rotten|гнилой
rough|грубый
rough up|грубо обращаться
round|круг
round down|округлить
rouse|будить
route|маршрут
row|грести
row|ряд
royal|королевский
rub|тереть
rubber|резина
rubbish|мусор
rubble|щебень
rude|грубый
ruffle|рябить
rug|коврик
rugged|неровный
ruin|разрушать
rule|правило
rule|править
ruler|линейка
rumble|грохот
rumor |слух
run|управлять
run after|гнаться за
run away|убежать
run counter|противоречить
run into|случайно встретить
run out of|исчерпать запас
run over|переехать машиной
runaway|беглый
runway|взлетная полоса
rupture|разрыв
rural|сельский
rush|торопиться
rust|ржавчина
rustic|деревенский
rustle|шелест
rut|борозда
ruthless|беспощадный
sack|мешок
sacred|священный
sacrifice|жертва
saddle|седло
safe|надежный
sail|парус
saint|святой
salary|зарплата
sale|продажа
salesperson|продавец
salient|выступающий
saliva|слюна
salmon|лосось
salt|соль
salvage|спасти
salvation|спасение
sample|образец
sanctuary|убежище
sand|песок
sane|здравый
satellite|спутник
satisfy|удовлетворять
saturated|насыщенный
saucepan|кастрюля
saucer|блюдце
sausage|колбаса
savage|дикарь
save up|накопить
savings|сбережения
savior|спаситель
savor|вкус
scaffold|помост
scale|чешуя
scale|взбираться
scale|масштаб
scales|весы
scant|скудный
scar|шрам
scarce|редкий
scare|пугать
scarf|шарф
scarlet|алый
scatter|разбрасывать
scent|нюх
schedule|график
scheme|схема
scholar|ученый
scholarship |стипендия
science|наука
scissors|ножницы
scold|ругать
scoop|совок
scope|пределы
score|счет
scorn|презирать
scour|обыскать
scout|разведчик
scowl|насупиться
scramble|драка
scramble|карабкаться
scrambled eggs|яичница
scrap|обломок
scrape|скрести
scrape through|с трудом пройти
scrape together|наскрести
scratch|царапать
scream|кричать
screech|визг
screenplay|сценарий
screw|винт
screw|к черту
screw up|завалить
scribble|криво написать
scrub|чистить
scrutiny|внимательный осмотр
scurry|бежать
seal|печать
seal|тюлень
seam|шов
search|поиски
seasoning|приправа
seat|место
secular|светский
secure|безопасный
sediment|осадок
seduce|соблазнять
see off|провожать
see through|довести до конца
see to|заняться
seed|семя
seek |искать
seem|казаться
seep|просачиваться
segregate|разделять
seize|схватить
seldom|редко
select|выбирать
selfish|эгоистичный
sell out of|распродать
send |отправить
send out|рассылать
senior|старший
sensation|ощущение
sense|чувство
sense|смысл
sensible|разумный
sensitive|чувствительный
sentence|предложение
sentence|приговор
sentiment|настроение
separate|отдельный
sequence|последовательность
serene|безмятежный
series|сериал
sermon|проповедь
serve|служить
serve|сидеть
serve|подавать
set|набор
set |установить
set about|приступить
set down|написать
set out|разъяснять
set out for|отправиться
set smb back|задержать
set smb back|обойтись в
set smb up|подставить
set smb up with|устроить
set smb up with|познакомить
settle|уладить
settle|селиться
settle for|согласиться на
settle in|освоиться
settle on|определиться с
sever|разрывать
several|несколько
severe|серьезный
sew|шить
sewage|канализация
sex|пол
shabby|облезлый
shack|лачуга
shade|тень
shade|оттенок
shadow|тень
shaft|вал
shaft|шахта
shake |трясти
shake |пожать
shake off|отделаться
shake up|встряхнуть
shallow|мелкий
shame|стыд
shape|форма
share|делить
share|разделять
shareholder|акционер
shark|акула
sharp|острый
shatter|разрушить
shave|брить
shed|сарай
shed |проливать
sheep |овца
sheer|явный
sheer|отвесный
sheet|лист
shelf |полка
shell|скорлупа
shelter|укрытие
shepherd|пастух
shield|щит
shift|сменить
shift|смена
shimmer|мерцать
shine |сиять
ship|доставлять
shirt|рубашка
shiver|дрожь
shoe|туфля
shoot |стрелять
shoot |снимать
shore|берег
shortage|нехватка
shoulder|плечо
shout|кричать
shove|резко толкнуть
shovel|лопата
show around|показать места
show off|показать всем
show up|прийти
showcase|витрина
shower|душ
shred|мелко порубить
shrewd|проницательный
shriek|пронзительный крик
shrimp|креветка
shrine|святыня
shrink |сжаться
shroud|пелена
shrub|куст
shrug|пожать плечами
shudder|содрогаться
shuffle|перемешивать
shun|избегать
shut |закрыть
shut out|не впускать
shut up|заткнуться
shy|застенчивый
siblings|братья и сестры
sick|больной
sideline|что-то вторичное
sidewalk|тротуар
sideways|вбок
siege|осада
sift|просеять
sigh|вздох
sight|вид
sight|достопримечаетльность
sign|знак
sign|подпись
sign up|записаться
signature|подпись
significant|значительный
signify|означать
silent|тихий
silk|шелк
sill|подоконник
silly|глупый
similar|похожий
simmer|медленно кипятить
simple|простой
simulate|моделировать
simultaneous|одновременный
sin|грех
since|поскольку
since|с
sincere|искренний
single|один
singular|единственный
sinister|зловещий
sink|раковина
sink |тонуть
sip|глоток
sit around|просто сидеть
sit back|отсидеться
sit out|высидеть
site|местоположение
situate|располагать
size up|изучить
skate|конек
sketch|набросок
ski|ездить на лыжах
skid|заносить
skill|умение
skillet|сковорода
skim|скользить
skin|кожа
skinny|тощий
skip|прыгать
skirt|юбка
skull|череп
slab|плита
slack|расслабление
slam|хлопать
slant|наклон
slap|шлепать
slash|рубить
slate|шифер
slaughter|бойня
slave|раб
slay |умертвить
sleek|гладкий
sleep around|трахаться
sleeve|рукав
slender|тонкий
slice|ломтик
slick|скользкий
slide |скользить
slight|легкий
slim|стройный
slime|слизь
slip|скользнуть
slipper|тапок
slippery|скользкий
slit|щель
slope|склон
sloppy|небрежный
slot|разъем
slow down|замедлиться
sludge|осадок
slum|трущобы
slump|спад
slut|шлюха
sly|лукавый
smack|шлепнуть
smart|умный
smash|громить
smear|мазать
smell|запах
smirk|ухмылка
smooth|гладкий
smother|задушить
smudge|смазать
smuggle|провозить тайно
snack|легкая закуска
snag|коряга
snail|улитка
snake|змея
snap|щелкать
snapshot|снимок
snarl|рычать
snatch|схватить
sneak|красться
sneakers|кеды
sneer|усмешка
sneeze|чихать
sniff|нюхать
snore|храп
snort|фыркнуть
snowball|снежок
snug|уютный
so far|до сих пор
soak|мочить
soap|мыло
soar|парить
sob|рыдать
sober|трезвый
sober up|протрезветь
so-called|так называемый
soccer|футбол
society|общество
sock|носок
socket|разъем
soften|смягчать
software|программое обеспечение
soil|почва
solar|солнечный
sole|единственный
sole|подошва
solemn|торжественный
solid|сплошной
solid|твердый
solitary|уединенный
solitude|одиночество
solution|решение
solution|раствор
solve|решить
someday|когда-нибудь
somewhat|слегка
soon|скоро
soot|сажа
soothe|успокаивать
sophisticated|сложный
sore|больной
sorrow|горе
sound|здоровый
sour|кислый
source|источник
south|юг
sovereign|суверенный
sow |сеять
space|пространство
space|космос
spade|лопата
span|пролет
spare|щадить
spare|запасной
spare|выделить
spark|искра
sparkle|сверкать
sparse|редкий
spawn|порождать
speak out|высказать
speak up|говорить громче
spear|копье
special|особенный
species|вид
specific|конкретный
specify|указать
specimen|образец
speck|пятнышко
spectacle|зрелище
spectator|зритель
speculate|предполагать
speed up|ускориться
spell|заклинание
spell|произносить
spell out|разъяснить
spend |тратить
spice|пряность
spike|шип
spill|проливать
spin|крутить
spine|позвоночник
spirit|дух
spit |плевать
splash|брызги
splendid|великолепный
splinter|шепка
split |расколоться
split up|разделиться
spoil|портить
spokesman|представитель
sponge|губка
spooky|жуткий
spot|место
spot|пятно
spot|заметить
spotlight|прожектор
spouse|супруг
sprawl|растягиваться
spread |распространять
spring |прыгать
spring |источник
sprinkle|побрызгать
sprout|росток
spur|шпора
spy |шпион
squad|команда
square|квадрат
square|площадь
squash|раздавливать
squat|приседать
squeak|пищать
squeal|визг
squeeze|сжимать
squid|кальмар
squint|щуриться
squirm|извиваться
squirrel|белка
squirt|тонкая струя
stab|ударить ножом
stable|устойчивый
stack|стопка
staff|персонал
stage|сцена
stage|стадия
stagger|шататься
stain|пятно
stairs|ступеньки
stake|стойка
stake|ставка
stale|несвежий
stalk|красться
stalk|стебель
stall|задержаться
stall|палатка
stamp|печать
stance|поза
stand|терпеть
stand against|противостоять
stand by|поддерживать
stand for|выступать за
stand for|обозначать
stand out|выделяться
standpoint|точка зрения
staple|скоба
stare|пялиться
stark|четкий
start up|основать
startle|испугать
starve|голодать
stash|тайник
state|государство
state|состояние
state|заявить
stature|рост
statutory|установленный законом
stay|оставаться
stay|остановиться пожить
stay up|не ложиться
steady|устойчивый
steal |красть
stealth|скрытность
steam|пар
steel|сталь
steep|крутой
steer|управлять
stellar|звездный
stem|стебель
step|шаг
step down|уйти в отставку
step in|вмешаться
stern|суровый
stew|тушить
stick|палка
stick |приклеить
stick at|упорно продолжать
stick out|торчать
stick to|придерживаться
stick together|держаться вместе
stiff|жесткий
stifle|удушать
still|спокойный
sting |жалить
stink |вонять
stir|шевелить
stir up|вызвать
stitch|стежок
stock|запас
stock|акции
stock up on|запастись
stocking|чулок
stomach|желудок
stomp|топать
stool|табурет
stoop|крыльцо со ступеньками
stoop|наклоняться
stop over|заехать
store|хранить
store|магазин
stout|толстый
stove|плита
straight|прямой
straightforward|простой
strain|напрягать
strait|пролив
strand|застрять
strand|прядь
strangle|придушить
strap|ремень
straw|солома
strawberry|клубника
stray|бродить
streak|полоса
stream|поток
strength|сила
stress|подчеркнуть
stretch|тянуть
strew |разбрасывать
strict|строгий
stride |шагать
strike|забастовка
strike |бить
strike out|потерпеть неудачу
string|струна
stringent|строгий
strip|полоса
strip|снимать
stripe|полоса
strive |стремиться
stroke|гладить
stroll|прогулка
struggle|бороться
stubborn|упрямый
stud|шпилька
stuff|вещи
stuffy|душный
stumble|спотыкаться
stump|пень
stun|ошеломить
stunt|трюк
stupid|глупый
sturdy|крепкий
subdue|подавить
subject|предмет
subject|подверженный
sublime|возвышенный
submerge|погружаться под воду
submit|подавать информацию
submit to|подчиниться
subordinate|подчиненный
subscribe|подписываться
subsequent|последующий
subside|утихать
subsidiary|вспомогательный
subsist|существовать
substance|вещество
substantial|существенный
substantive|существенный
substitute|заменять
subtitle|субтитры
subtle|тонкий
subtract|вычитать
suburb|пригород
subvert|подорвать
subway|метро
succeed|достичь цели
success|успех
succession|последовательность
successor|преемник
succumb|поддаться
suck|сосать
sudden|внезапный
sue|предъявить иск
suffer|страдать
suffice|хватать
sufficient|достаточный
suffocate|задыхаться
suggest|предлагать
suit|костюм
suit|подходить
suitcase|чемодан
suite|апартаменты
sulfur |сера
sum|сумма
sum up|подытожить
summary|сводка
summit|вершина
summon|вызывать
sunset|закат солнца
superb|превосходный
superficial|поверхностный
superintendent|управляющий
superior|высший
supervise|надзирать
supplement|дополнение
supply|поставлять
supply|предложение
support|поддерживать
suppose|полагать
suppress|подавлять
supreme|высший
sure|уверенный
surf|прибой
surface|поверхность
surge|волна
surgery|хирургия
surpass|превзойти
surplus|избыток
surprise|удивлять
surrender|сдаваться
surround|окружать
surveillance|наблюдение
survey|обзор
survive|выжить
susceptible|восприимчивый
suspect|подозревать
suspend|приостановить
suspicious|подозрительный
sustain|поддерживать
swallow|проглатывать
swamp|болото
swan|лебедь
swap|менять
swarm|рой
sway|раскачивать
swear|клясться
swear|ругаться
sweat|пот
sweep|размах
sweep |подметать
sweetheart|возлюбленный
swell |раздуваться
swift|быстрый
swing |качать
swirl|кружить
switch|переключать
swoop|кинуться
sword|меч
syllable|слог
symbol|символ
sympathy|сочуствие
syringe|шприц
table|таблица
tablet|плитка
tack|канцелярская кнопка
tack|курс
tackle|принадлежности
tackle|взяться за
tag|этикетка
tail|хвост
tailor|портной
taint|загрязнить
take|воспринимать
take a look|взглянуть
take a walk|прогуляться
take aback|ошеломить
take advantage of|воспользоваться
take after|быть в
take apart|разбирать
take away|отнять
take care|позаботиться
take down|записать
take in|понять
take off|снять
take off|взлететь
take on|соревноваться
take on|набрать
take over|принять обязанности
take part|принимать участие
take place|происходить
take up|заняться чем-либо
talk into|уговорить
talk over|обговорить
talk smb out|отговорить
tall|высокий
tally|подсчитывать
tame|ручной
tan|загар
tangible|осязаемый
tangle|запутывать
tank|бак
tap|стучать
tap|кран
tape|лента
tar|смола
target|цель
tart|пирог
task|задание
taste|вкус
tattered|оборванный
taunt|насмехаться
tax|налог
team|команда
tear|слеза
tear |рвать
tease|дразнить
tedious|утомительный
tell apart|различать
tell from|отличить
tell off|ругать
tell on|донести на кого-то
temper|характер
temple|храм
temple|висок
temporary|временный
tempt|искушать
tenant|арендатор
tend|иметь склонность
tend|ухаживать
tender|нежный
tense|напряженный
tent|палатка
tentative|пробный
term|срок
term|термин
terminal|конечный
terminate|прекратить
terms|отношения
terms|условия
terrain|местность
terrible|ужасный
terrify|устрашать
terror|ужас
testament|завет
testify|свидетельствовать
testimony|показание
text|писать
thank|благодарить
thaw|оттепель
theater |театр
theft|кража
theme|тема
thereafter|впоследствии
thereby|тем самым
therefore|следовательно
thermal|тепловой
thick|толстый
thick|густой
thief |вор
thigh|бедро
thin|тонкий
think over|обдумать
thirst|жажда
thorn|шип
thorough|основательный
though |хотя
thought|мысль
thread|нить
threat|угроза
threshold|порог
thrift|бережливость
thrill|трепет
thrive|процветать
throat|горло
throng|толпа
throw |бросать
throw away|выбрасывать
throw up|блевануть
thrust|сунуть
thud|глухой удар
thug|бандит
thumb|большой палец
thump|колотить
thunder|гром
thus|таким образом
thwart|помешать
tick|галочка
tick|клещ
ticket|билет
tickle|щекотать
tide|волна
tidy|опрятный
tie|галстук
tie|связывать
tied up|занятый
tier|ярус
tight|тугой
tile|плитка
tilt|наклонять
timber|древесина
timely|своевременный
timetable|расписание
timid|робкий
tin|олово
tinker with|возиться
tint|оттенок
tiny|крошечный
tip|кончик
tip|совет
tip |чаевые
tip smb off|предупредить
tire |шина
tired|усталый
tissue|ткань
tissue|бумажная салфетка
title|заголовок
toddler|малыш
toe|палец
toil|тяжело трудиться
token|знак
tolerate|терпеть
toll|плата
tomb|надгробие
tongue|язык
tool|инструмент
tooth |зуб
topic|тема
topple|опрокинуть
tops|самое большое
torch|факел
torment|мучение
torture|пытка
toss|бросать
total|полный
touch|связь
touch|касаться
tough|жесткий
tournament|турнир
tout|рекламировать
tow|буксир
toward |по направлению к
towel|полотенце
tower|башня
toy with|подумывать о ч-л
trace|след
track|след
track down|разыскать
trade|торговля
traffic light|светофор
trail|след
train|поезд
train|тренировать
trait|черта
traitor|изменник
tram|трамвай
tramp|бродяга
tranquil|спокойный
transcend|преодолеть
transcript|расшифровка
transfer|перевести
transition|переход
transmit|передавать
transparent|прозрачный
trap|ловушка
trash|мусор
tray|лоток
treachery|предательство
tread|ступать
treasure|сокровище
treat|обращаться
treaty|договор
trek|поход
tremble|дрожать
tremendous|громадный
trench|траншея
trial|испытание
trial|судебный процесс
triangle|треугольник
tribe|племя
tribute|дань
trick|трюк
trickle|струйка
trigger|спусковой крючок
trim|подстригать
trip|поездка
triple|тройной
troop|отряд
trophy|трофей
troublesome|хлопотный
trousers|брюки
trout|форель
truck|грузовик
trump|козырь
trumpet|труба
trunk|багажник
trunk|ствол дерева
trunk|чемодан
trust|доверять
try on|примерить
try out|испытать
tub|ванна
tube|тюбик
tube|труба
tube|метро
tuck|подоткнуть
tug|тянуть
tuition|обучение
tumble|перевернуться
tumor |опухоль
tuna|тунец
tune|мелодия
tune|настраивать
turkey|индейка
turmoil|смятение
turn|очередь
turn away|не пустить
turn down|отказаться от предложения
turn into|превращать
turn off|выключить
turn off|свернуть
turn on|включить
turn on|заводить
turn out|оказаться
turn over|перевернуть
turn up|сделать погромче
turnover|оборот
turtle|черепаха
tutor|репетитор
tweak|доделать
twig|прут
twilight|сумерки
twin|близнец
twinkle|блеск
twirl|вертеть
twist|скручивать
twitch|дергаться
type|печатать
ugly|безобразный
ultimate|окончательный
umbrella|зонтик
unanimous|единогласный
unbelievable|невероятный
uncle|дядя
undergo|пройти через
underground|подземный
underlie|лежать в основе
underline|подчеркивнуть
undermine|подрывать
underneath|под
underpants|трусы
underscore|нижнее подчеркивание
undertake|предпринимать
underwear|нижнее белье
undo|расстегнуть
union|союз
unique|уникальный
unit|единица
unite|объединять
universe|вселенная
unless|если не
upcoming|предстоящий
update|обновлять
uphill|в гору
uphold|соблюдать
upper|верхний
upright|вертикальный
upright|честный
uprising |восстание
upset|расстраивать
upside down|вверх ногами
up-to-date|современный
upwards |вверх
urban|городской
urge|побуждать
urgent|срочный
usage|применение
used to|когда-то бывало
useful|полезный
utility|полезность
utilize|использовать
utter|полный
utter|издать
vacation|отпуск
vague|смутный
vain|тщеславный
vain|напрасный
valid|действительный
valley|долина
value|ценность
valve|задвижка
van|фургон
vanish|исчезнуть
vapor|пар
variety|разнообразие
various|разнообразный
varnish|лак
vary|меняться
vase|ваза
vast|просторный
vault|свод
vault|хранилище
veer|резко свернуть
vegetable|овощ
vegetation|растительность
vehicle|транспортное средство
veil|вуаль
vein|вена
velocity|быстрота перемещения
velvet|бархат
vendor|продавец
vengeance|отмщение
vent|выход
venture|авантюра
verb|глагол
verge|обочина
verge|грань
verify|проверить
versatile|универсальный
verse|стих
vessel|сосуд
vessel|судно
vest|жилет
via|через
viable|жизнеспособный
vice|порок
vicinity|окрестность
vicious|злобный
victim|жертва
view|вид
vigil|дежурство
vigor|сила
village|деревня
villain|негодяй
vine|виноград
vinegar|уксус
violate|нарушать
violent|яростный
violet|фиолетовый
violin|скрипка
virgin|девственница
virtual|действительный
virtue|достоинство
visible|видимый
vision|зрение
visit|посетить
vital|жизненный
vivid|яркий
vocabulary|словарный запас
vocation|призвание
void|недействительный
volatile|изменчивый
volume|громкость
volume|том
volume|объем
voluntary|добровольный
vomit|рвота
vote|голосовать
vow|клятва
voyage|путешествие
vulnerable|уязвимый
wad|комок
wade|брод
waffle|вафля
wag|махать
wage|заработок
wail|вопить
waist|талия
waiter|официант
waive|отказаться
wake |просыпаться
wallet|бумажник
wallpaper|обои
walnut|грецкий орех
wander|бродить
wane|убывать
ward|палата
ward|округ
ward off|предотвратить
warden|смотритель
wardrobe|шкаф
warehouse|склад
warfare|военные действия
warmth|тепло
warn|предостерегать
warp|деформироваться
warrant|гарантировать
warrior|воин
wary|осторожный
wash down|запивать
wash up|умыться
wash up|помыть посуду
waste|отходы
waste|тратить
watch|часы
watchful|бдительный
water down|разбавить
watercolor|акварель
waterfall|водопад
wave|волна
wave|махать
waver|дрогнуть
wax|воск
way|способ
weak|слабый
wealth|богатство
weapon|оружие
wear|надевать
wear off|сойти на нет
wear out|измотать
weary|утомленный
weave|плести
wedding|свадьба
wedge|клин
weed|сорняк
weep|рыдать
weigh|весить
weight|вес
weird|нереальный
welcome|желанный
weld|сварка
welfare|пособие
welfare|благополучие
well|колодец
well-being|благополучие
well-off|обеспеченный
west|запад
wet|мокрый
whack|удар
whale|кит
whatsoever|совсем
wheat|пшеница
wheel|колесо
whereabouts|местонахождение
whereas|тогда как
whereby|посредством чего
whether|ли
whim|каприз
whine|ныть
whip|кнут
whirl|вихрь
whisk|сделать быстрое движение
whisper|шептать
whistle|свист
whiz|ловкач
whiz|просвистеть
whole|весь
wholesale|опт
wicked|злобный
wide|широкий
widespread|распространенный
widow|вдова
width|ширина
wield|владеть
wiggle|шевелить
wilderness|глушь
wildlife|дикая природа
will|воля
willow|ива
wince|поморщиться
wind |наматывать
wind up|заканчивать
windowpane|оконное стекло
wine|вино
wink|подмигивать
wipe|вытирать
wipe out|уничтожить
wire|проволока
wise|мудрый
wit|ум
witch|ведьма
withdraw|отводить
wither|увянуть
withhold|утаивать
within|в течение
within|в пределах
withstand|выдерживать
witness|свидетель
wizard|волшебник
wobble|качаться
woe|горе
wonder|удивление
wonder|хотеть знать
woo|ухаживать
wood|древесина
wool|шерсть
work out|тренироваться
work out|получиться
workshop|мастерская
worldwide|всемирный
worm|червь
worry|волновать
worsen|ухудшать
worship|почитать
worth|стоимость
worthwhile|стоящий
wound|рана
wrap|заворачивать
wrath|ярость
wreath|венок
wreck|разрушать
wrench|гаечный ключ
wrestle|бороться
wretched|жалкий
wrinkle|морщина
wrist|запястье
write out|выписать
wrong|не тот
wrongdoing|проступок
yacht|яхта
yank|дергать
yard|двор
yawn|зевать
yearn|тосковать
yell|кричать
yet|пока еще
yet|все же
yield|уступать
yield|приносить
youngster|юноша
youth|молодежь
zeal|рвение
zipper|молния
zoo|зоопарк
advance|продвигать
abandon|покидать
abroad|за границей
abrupt|резкий
absence|отсутствие
absorb|поглощать
absurd|абсурдный
abyss|бездна
accident|несчастный случай
accompany|сопровождать
accomplish|выполнить
accord|аккорд
accurate|точный
accurse|проклинать
accustom|приучать
achieve|достигать
acknowledge|сознавать
acquaint|знакомить
acquaintance|знакомство
active|активный
activity|активность
admiration|восхищение
admire|восхищаться
adult|взрослый
advantage|преимущество
adventure|приключение
advice|совет
advise|советовать
affair|роман
affect|оказывать воздействие
affection|привязанность
affectionate|любящий
afford|позволить себе
agent|агент
agony|агония
agree|соглашаться
agreeable|приятный
aid|помогать
aim|цель
alas|увы
alien|чужак
alley|переулок
aloud|вслух
alter|изменить
altogether|в целом
amaze|удивлять
amazement|изумление
america|америка
american|американский
amiable|любезный
amid|среди
amidst|среди
amongst|среди
amount|сумма
amuse|развлекать
anger|гнев
angle|угол
ankh|анкх
ankle|лодыжка
announce|объявлять
annoy|раздражать
anxiety|беспокойство
anyhow|в любом случае
anymore|больше
anywhere|где угодно
apartment|квартира
appeal|обращаться
apple|яблоко
apply|применять
appoint|назначать
apprehension|опасение
arch|арка
area|область
argue|спорить
argument|аргумент
arise|возникают
armor|броня
army|армия
arrange|договариваться
arrangement|договоренность
arrest|арестовать
arrival|прибытие
arrow|стрелка
article|статья
artist|художник
ash|пепел
ashamed|стыдящийся
aspect|аспект
assemble|собрать
assistant|помощник
associate|ассоциированный
assume|предполагать
astonish|удивлять
astonishment|изумление
atmosphere|атмосфера
attach|прикреплять
attend|посещать
attendant|дежурный
attic|чердак
attitude|отношение
attract|привлекать
audience|аудитория
auditor|аудитор
august|август
authority|власть
autumn|осень
avenue|авеню
await|ждать
awaken|пробудить
awkward|неловкий
axe|топор
baby|малыш
background|фон
backward|назад
badge|значок
balance|баланс
bald|лысый
balloon|воздушный шар
band|группа
bang|хлопнуть
bargain|торговаться
bark|лаять
barnacle|морская уточка
barrel|бочка
base|база
basil|базилик
basket|корзина
bat|летучая мышь
bath|ванна
bathroom|ванная комната
batter|тесто
bay|залив
beach|пляж
beam|луч
bearer|предъявитель
beast|зверь
beckon|манить
bed|кровать
bedroom|спальня
bee|пчела
beer|пиво
behave|вести себя
behold|вот
being|существование
belief|вера
bellow|реветь
belt|пояс
bench|лавка
bet|ставка
betray|предавать
bewilder|сбивать с толку
bid|делать ставку
bigger|больше
bile|желчь
birth|рождение
birthday|день рождения
bit|кусочек
bitter|горький
blackness|чернота
blade|лезвие
blame|винить
blank|пустой
blanket|одеяло
blast|взрыв
blaze|полыхать
bleed|кровоточить
blink|моргать
block|блокировать
bloody|кровавый
blossom|цвести
blur|размытие
blush|краснеть
bob|боб
boil|кипятить
bold|смелый
bolt|болт
bomb|бомбить
bonnet|капот
boom|бум
border|граница
bore|отверстие
borrow|занимать
bosom|грудь
bother|беспокоить
bounce|подпрыгивать
bowl|чаша
brandy|бренди
brass|латунь
brave|храбрый
bread|хлеб
breathe|дышать
breathless|затаивший дыхание
breeze|ветерок
brick|кирпич
brilliant|блестящий
brisk|оживленный
british|британский
bronze|бронза
brood|выводок
broom|метла
broomstick|метла
brow|бровь
brush|щетка
bubble|пузырь
buck|доллар
bug|ошибка
building|здание
bulge|выпуклость
bullet|пуля
bunch|связка
bundle|пучок
burden|бремя
bus|автобус
bush|куст
butter|масло
button|кнопка
buzz|гул
bye|пока
cabin|кабина
cable|кабель
cage|клетка
cake|торт
camera|камера
camp|лагерь
cap|колпачок
capable|способный
capital|капитал
capture|захватывать
career|карьера
careless|беспечный
carpet|ковер
carriage|перевозка
cart|тележка
carve|вырезать
casual|повседневный
cauldron|котел
caution|осторожность
cautious|осторожный
cavern|пещера
cease|прекратить
cell|клетка
cellar|подвал
center|центр
central|центральный
centre|центр
ceremony|церемония
champion|чемпион
channel|канал
chant|скандировать
chap|глава
chase|гнаться
chatter|болтовня
cheap|дешевый
cheer|радость
cheerful|веселый
chew|жевать
chicken|курица
chill|холод
chimney|камин
chin|подбородок
chocolate|шоколад
choice|выбор
choke|душить
christmas|рождество
chuckle|хихиканье
churchyard|церковный двор
cigar|сигара
cigarette|сигарета
citizen|гражданин
clad|одетый
claim|требовать
clang|лязг
clap|хлопать
clasp|застежка
classroom|класс
clatter|грохот
claw|коготь
clench|сжимать
clerk|клерк
clever|умный
click|нажмите
cling|цепляться
cloth|ткань
club|клуб
clue|подсказка
clumsy|неуклюжий
cluster|кластер
coach|тренер
coal|уголь
coast|побережье
cock|петух
code|код
coffee|кофе
coffin|гроб
coil|катушка
coin|монета
collapse|крах
collar|воротник
collect|собирать
college|колледж
colon|толстая кишка
colonel|полковник
color|цвет
column|столбец
comment|комментарий
commit|совершить
communication|коммуникация
compare|сравнивать
complain|жаловаться
complex|сложный
complicate|усложнять
compliment|комплимент
computer|компьютер
comrade|товарищ
conceal|скрыть
concentrate|концентрат
conclude|заключить
conclusion|заключение
conduct|руководить
confess|признаваться
confidence|уверенность
confirm|подтверждать
confuse|запутать
confusion|путаница
connect|соединять
connection|соединение
conscious|сознательный
consciousness|сознание
consent|согласие
consequence|последствие
considerable|значительный
consideration|рассмотрение
constant|постоянный
consult|проконсультироваться
contact|контакт
content|содержание
contrary|вопреки
convey|передавать
convince|убеждать
cook|готовить
cop|коп
copy|копия
corp|корпорация
corpse|труп
correct|правильный
cost|стоимость
cottage|коттедж
cough|кашель
council|совет
counsel|совет
countenance|выражение лица
counter|прилавок
courage|мужество
cousin|двоюродный брат
cow|корова
crackle|треск
craft|ремесло
crash|крушение
crazy|сумасшедший
creak|скрип
cream|крем
credit|кредит
crew|экипаж
crime|преступление
criminal|преступник
crook|мошенник
cruel|жестокий
crumble|крошиться
crush|раздавить
crystal|кристалл
cunning|хитрость
cupboard|шкаф
cur|дворняжка
cure|излечивать
curiosity|любопытство
curl|завиток
current|текущий
curtain|занавес
curve|изгиб
custom|обычай
dad|папа
dale|дол
damage|повреждать
damn|черт
damp|влажный
dan|Дэн
darken|темнеть
darling|милый
dart|дротик
dash|бросаться
data|данные
date|дата
david|Дэвид
daylight|дневной свет
dean|декан
debate|дебаты
decay|разлагаться
deceive|обманывать
decent|приличный
decision|решение
deck|палуба
declare|объявить
deed|поступок
defeat|поражение
defend|защищать
defense|защита
definite|определенный
degree|степень
delay|задерживать
delicate|деликатный
delightful|восхитительный
deliver|доставлять
demand|требовать
demon|демон
den|логово
deny|отрицать
depart|отходить
department|отделение
departure|отправление
depend|зависеть
depress|подавлять
depth|глубина
descend|спускаться
describe|описывать
description|описание
deserve|заслуживать
design|дизайн
despair|отчаяние
despite|несмотря на
detect|обнаружить
determine|определять
develop|развивать
device|устройство
devil|дьявол
devote|посвящать
diary|дневник
dick|хуй
difference|разница
difficulty|трудность
dignity|достоинство
dimension|измерение
din|гам
dip|окунать
dirty|грязный
disappoint|разочаровать
disappointment|разочарование
discovery|открытие
discuss|обсуждать
discussion|обсуждение
disease|болезнь
disguise|маскировка
disgust|отвращение
dish|блюдо
dislike|не нравится
dismal|унылый
dismiss|увольнять
display|отображать
dispose|распоряжаться
distinct|отчетливый
distinguish|различать
distract|отвлекать
distress|бедствие
div|див
divide|разделять
dizzy|головокружение
dollar|доллар
doom|рок
doorway|дверной проем
dormitory|общежитие
dot|точка
doubtful|сомнительно
downstairs|внизу
downward|вниз
doze|дремать
drain|осушать
draught|черновик
drawer|ящик
drip|капать
driver|водитель
droop|свисать
drown|тонуть
drug|наркотик
drum|барабан
dublin|дублин
duchess|герцогиня
duck|утка
due|причитающийся
duke|герцог
dull|тупой
dungeon|подземелье
dusk|сумерки
dusty|пыльный
dye|краситель
eager|жаждущий
eagle|орел
earn|зарабатывать
earnest|серьезный
ease|простота
eastern|восточный
eastward|на восток
eater|едок
edward|Эдвард
egg|яйцо
elbow|локоть
elder|старший
electric|электрический
element|элемент
eleven|одиннадцать
elsewhere|в другом месте
embarrass|смущать
embrace|обнимать
emerge|появляться
emotion|эмоция
employ|нанимать
encounter|встреча
encourage|поощрять
endless|бесконечный
endure|терпеть
energy|энергия
engage|привлекать
engine|двигатель
england|англия
english|английский
enormous|огромный
entertain|развлекать
entity|сущность
envelope|конверт
equal|равный
equipment|оборудование
ere|эре
ernest|Эрнест
errand|поручение
establish|учреждать
estate|имущество
eventual|в конечном итоге
everywhere|повсюду
evidence|доказательство
example|пример
exceeding|превышающий
excellent|отличный
exchange|обмен
excitement|возбуждение
exclaim|воскликнуть
exercise|упражнение
exhaust|выхлоп
exist|существовать
existence|существование
expedition|экспедиция
expensive|дорогой
experiment|эксперимент
explanation|объяснение
explode|взорваться
explore|исследовать
explosion|взрыв
expose|разоблачать
extend|продлевать
extent|степень
extra|дополнительный
extraordinary|необычайный
eyebrow|бровь
faith|вера
faithful|верный
false|ложный
famous|известный
fan|веер
fang|клык
fantastic|фантастический
farewell|прощание
farm|ферма
farmer|фермер
farther|дальше
fascinate|очаровывать
fasten|закрепить
faster|быстрее
fate|судьба
fault|вина
favour|услуга
favourite|любимый
fearful|страшный
feast|праздник
feather|перо
feature|особенность
feeble|слабый
feeling|чувство
female|женский
fence|изгородь
fetch|принести
fever|лихорадка
fierce|яростный
fifteen|пятнадцать
fifth|пятый
filch|украсть
file|файл
fir|ель
firebolt|зажигалка
fireplace|камин
fist|кулак
flag|флаг
flap|лоскут
flare|вспышка
flee|бежать
fleet|флот
flesh|плоть
flicker|мерцание
fling|бросать
flood|наводнение
flora|флора
flush|румянец
flutter|трепетать
focus|фокус
foe|враг
fog|туман
fond|любящий
foolish|глупый
footstep|шаг
forbid|запрещать
ford|форд
forehead|лоб
foreign|иностранный
forever|навсегда
forgive|простить
fork|вилка
former|бывший
fortunate|повезло
fortune|удача
forty|сорок
foul|грязный
fountain|фонтан
fourth|четвертый
fragment|фрагмент
frame|рамка
frank|откровенный
frantic|неистовый
freedom|свобода
freeze|заморозить
french|французский
frequent|частый
friendship|дружба
fright|испуг
frightful|ужасный
fro|фро
frog|лягушка
frown|хмуриться
fruit|фрукты
fry|жарить
fudge|помадка
fully|полностью
fumble|шарить
fun|веселье
funeral|похороны
funny|забавный
fur|мех
furious|яростный
furniture|мебель
fury|ярость
gain|прирост
galaxy|галактика
gallop|галопом
gang|банда
gap|зазор
gas|газ
gaunt|изможденный
gay|гей
gaze|взгляд
gear|шестерня
generation|поколение
generous|щедрый
genius|гений
genuine|подлинный
german|немецкий
gesture|жест
ghastly|ужасный
ghoul|упырь
giant|гигант
gift|подарок
gigantic|гигантский
glare|блики
glide|скольжение
glimmer|мерцание
glint|блеск
glisten|блестеть
glitter|блеск
gloom|мрак
gloomy|хмурый
glory|слава
glove|перчатка
goblet|кубок
goblin|гоблин
goodness|доброта
goose|гусь
government|правительство
gown|платье
grace|милость
graceful|изящный
gracious|любезный
gradual|постепенный
grand|большой
grandfather|дедушка
grant|грант
grasp|понять
grateful|благодарный
gratitude|благодарность
greet|приветствовать
grief|горе
grim|мрачный
grip|хватка
grippe|грипп
groan|стон
grope|ощупывать
grotesque|гротеск
grove|роща
growl|рычание
grumble|ворчать
grunt|хрюкать
guest|гость
guilty|виновный
gulf|залив
guy|парень
habit|привычка
hail|град
halfway|наполовину
ham|ветчина
hammer|молоток
handful|горстка
handkerchief|носовой платок
handsome|красивый
happiness|счастье
harder|Сильнее
hark|слушай
harm|вред
harmony|гармония
harsh|жесткий
haste|спешка
hasten|спешить
hasty|поспешный
hate|ненавидеть
haul|тащить
haunt|преследовать
heal|лечить
health|здоровье
healthy|здоровый
heap|куча
hearty|сытный
heat|нагревать
heave|поднимать
hedge|хеджирование
heel|каблук
height|высота
heir|наследник
hello|привет
helm|шлем
helmet|шлем
helpless|беспомощный
hero|герой
hesitate|сомневаться
hey|привет
higher|выше
highest|самый высокий
hire|нанимать
hoarse|хриплый
holiday|праздничный день
hollow|пустой
honest|честный
hood|капюшон
hook|крюк
hopeful|обнадеживающий
hopeless|безнадежный
horizon|горизонт
hospital|больница
host|хозяин
hotel|отель
hover|зависнуть
howl|вой
huddle|ютиться
hug|обнимать
hum|гул
humble|скромный
hungry|голодный
hunt|охота
hunter|охотник
hurl|швырять
hurried|поспешил
hush|тишина
hut|хижина
ice|лед
icy|ледяной
idiot|идиот
idle|бездельничать
ignore|игнорировать
image|изображение
imagination|воображение
immense|огромный
imp|чертенок
impatient|нетерпеливый
importance|важность
impress|произвести впечатление
impression|впечатление
impressive|впечатляющий
improve|улучшать
incident|инцидент
incline|наклон
include|включать
increase|увеличивать
incredible|невероятный
indicate|указывать
indifferent|безразличный
individual|индивидуальный
infinite|бесконечный
influence|влияние
inform|информировать
injury|травма
ink|чернила
inn|гостиница
inner|внутренний
innocent|невиновный
inquire|спрашивать
inquiry|расследование
insect|насекомое
insist|настаивать
inspire|вдохновлять
instance|пример
instinct|инстинкт
instruction|инструкция
instrument|инструмент
insult|оскорблять
intelligence|интеллект
intend|намереваться
intense|интенсивный
intent|намерение
intention|намерение
interrupt|прерывать
interval|интервал
interview|интервью
introduce|представлять
invent|изобретать
investigation|расследование
invisible|невидимый
invite|приглашать
involve|вовлекать
ireland|ирландия
irish|ирландский
island|остров
issue|проблема
italian|итальянский
item|элемент
jack|Джек
jacket|куртка
jail|тюрьма
jar|банка
jaw|челюсть
jerk|придурок
jet|струя
jewel|драгоценность
joke|шутить
jordan|иордания
journal|журнал
joy|радость
jug|кувшин
justice|справедливость
keen|острый
keeper|хранитель
kindle|разжечь
kindness|доброта
king|король
kingdom|королевство
kitty|кошечка
kneel|встать на колени
knight|рыцарь
knot|узел
laboratory|лаборатория
labour|труд
lack|недостаток
lad|парень
ladder|лестница
landscape|пейзаж
lane|переулок
lantern|фонарь
lap|круг
lash|хлестать
latter|последний
laughter|смех
launch|запуск
lawn|лужайка
lawyer|адвокат
lazy|ленивый
leader|лидер
leaf|лист
league|лига
leather|кожа
legend|легенда
lend|одалживать
lesson|урок
lest|чтобы
lett|сдавать
liberty|свобода
librarian|библиотекарь
license|лицензия
lick|лизать
lid|крышка
lighter|легче
lightning|молния
likewise|так же
limb|конечность
limit|предел
limp|хромать
linger|задерживаться
link|связь
lion|лев
list|список
load|нагрузка
local|местный
lodge|домик
lofty|высокий
log|бревно
lone|одинокий
loom|ткацкий станок
lore|предания
loss|потеря
lover|любовник
luck|удача
lucky|удачливый
lump|кусок
lunch|обед
lurk|скрываться
madness|безумие
magical|волшебный
maid|служанка
mail|почта
maintain|поддерживать
majesty|величество
major|главный
male|мужской
mankind|человечество
mansion|особняк
map|карта
marble|мрамор
market|рынок
marriage|свадьба
marsh|болото
marvel|чудо
marvellous|чудесный
mask|маска
mass|масса
massive|массивный
material|материал
meal|еда
meanwhile|тем временем
measure|мера
meat|мясо
mechanical|механический
medical|медицинский
melt|таять
member|член
menace|угроза
mend|чинить
mental|умственный
merchant|торговец
mercy|милосердие
mess|беспорядок
messenger|посланник
method|метод
midnight|полночь
midst|середина
mild|мягкий
military|военный
milk|молоко
mill|мельница
mingle|смешаться
minister|министр
ministry|министерство
mirror|зеркало
miserable|убогий
misery|невзгоды
mission|миссия
mistake|ошибка
mistaken|ошибся
mistress|любовница
misty|туманный
mix|смешивать
moan|стон
mock|насмехаться
model|модель
modern|современный
mom|мама
monday|понедельник
monk|монах
monkey|обезьяна
monsieur|месье
monster|монстр
monstrous|чудовищный
mood|настроение
moonlight|лунный свет
moral|моральный
morrow|завтра
mortal|смертный
motion|движение
motive|мотив
motor|двигатель
mound|курган
mount|монтировать
mouse|мышь
mud|грязь
muffle|заглушить
mum|мама
mumble|бормотание
murder|убийство
muscle|мышца
museum|музей
musical|музыкальный
myrtle|мирт
mysterious|таинственный
mystery|тайна
myth|миф
nail|ноготь
nameless|безымянный
nasty|противный
national|национальный
native|родной
nay|нет
nearby|рядом
nearest|ближайший
neat|аккуратный
needle|игла
neighbourhood|район
nephew|племянник
nerve|нерв
net|сеть
nevertheless|тем не менее
newspaper|газета
nick|Ник
niece|племянница
nigger|негр
nigh|почти
nightmare|кошмар
noble|благородный
non|не
nonsense|чушь
noon|полдень
northern|северный
northward|на север
nostril|ноздря
notion|понятие
nowhere|нигде
nurse|медсестра
oak|дуб
obey|подчиняться
objection|возражение
oblige|обязывать
obscure|неясный
observation|наблюдение
obtain|получать
occupy|занимают
ocean|океан
october|октябрь
odour|запах
offend|обидеть
official|официальный
oil|масло
okay|хорошо
older|старше
operate|работать
operation|операция
opportunity|возможность
orange|апельсин
ordinary|обычный
organ|орган
original|оригинальный
otherwise|в противном случае
ourself|мы сами
outer|внешний
outline|контур
overcome|преодолеть
overhead|накладные расходы
owl|сова
owner|владелец
oxford|Оксфорд
pace|темп
pad|прокладка
painful|болезненный
palace|дворец
palm|ладонь
pan|кастрюля
panel|панель
panic|паника
pant|пыхтение
papa|папа
parchment|пергамент
pardon|помилование
park|парк
parlour|гостиная
partner|партнер
passe|пас
passion|страсть
passionate|страстный
pat|похлопать
patch|пластырь
patience|терпение
patient|пациент
patrician|патриций
pattern|узор
pavement|тротуар
paw|лапа
peaceful|мирный
peak|пик
peculiar|своеобразный
peep|подглядывать
peeve|раздражать
pen|ручка
pencil|карандаш
per|за
perceive|воспринимать
perch|окунь
perform|выполнять
performance|производительность
peril|опасность
period|период
perish|погибнуть
permission|разрешение
permit|разрешать
personality|личность
persuade|убеждать
pet|домашний питомец
peter|Питер
petunia|петуния
photograph|фотография
phrase|фраза
physical|физический
physician|врач
pie|пирог
pierce|прокалывать
pig|свинья
pillar|столб
pillow|подушка
pilot|пилот
pin|приколоть
pinch|ущипнуть
pine|сосна
pink|розовый
pipe|труба
pirate|пират
pit|яма
pitch|подача
pity|жалость
plane|самолет
plant|растение
plastic|пластик
platform|платформа
player|игрок
plenty|множество
plot|сюжет
plunge|нырять
poet|поэт
poison|яд
poke|тыкать
pole|полюс
polish|полировать
polite|вежливый
ponder|обдумать
pont|понт
pony|пони
pool|бассейн
pop|поп
port|порт
portrait|портрет
pose|поза
positive|положительный
possess|владеть
possession|владение
possibility|возможность
pot|горшок
potato|картофель
potion|зелье
powder|пудра
powerful|мощный
practical|практичный
practice|практиковать
praise|хвалить
prayer|молитва
precious|драгоценный
precise|точный
prefer|предпочитать
preparation|подготовка
preserve|сохранять
president|президент
pressure|давление
prevent|предотвращать
previous|предыдущий
prey|добыча
price|цена
pride|гордость
prince|принц
principal|главный
principle|принцип
print|печать
prison|тюрьма
prisoner|заключенный
proceed|продолжить
process|процесс
profession|профессия
professional|профессиональный
profound|глубокий
program|программа
progress|прогресс
project|проект
prompt|быстрый
proof|доказательство
property|свойство
propose|предлагать
prospect|перспектива
protect|защищать
protection|защита
protest|протест
provide|предоставлять
pry|подглядывать
puff|слойка
punch|удар кулаком
punish|наказывать
purchase|покупка
pure|чистый
purple|фиолетовый
pursue|преследовать
pursuit|преследование
puzzle|головоломка
quality|качество
quarrel|ссориться
quest|квест
quill|перо
quiver|колчан
rabbit|кролик
rack|стойка
radio|радио
raft|плот
rag|тряпка
rage|ярость
rail|рельс
range|диапазон
rank|классифицировать
rapid|стремительный
rare|редкий
rate|ставка
rattle|погремушка
ray|луч
reader|читатель
reality|реальность
realm|область
rear|задний
reasonable|разумный
recent|недавний
recognize|распознавать
recollect|вспоминать
recollection|воспоминание
recover|восстанавливаться
reduce|уменьшать
reef|риф
refer|ссылаться
reference|ссылка
reflect|отражать
reflection|отражение
refresh|обновить
refuse|мусор
region|область
regret|сожалеть
regular|обычный
relate|иметь отношение к
relation|отношение
relative|родственник
relax|расслабляться
release|выпускать
relief|облегчение
relieve|облегчать
reluctant|вынужденный
remarkable|замечательный
remembrance|воспоминание
remind|напоминать
remote|удаленный
render|оказывать
rent|арендовать
rep|представитель
repair|ремонт
replace|заменять
represent|представлять
request|запрос
require|требовать
rescue|спасать
research|исследовать
reserve|бронировать
resist|сопротивляться
resolution|резолюция
resolve|решать
respectable|респектабельный
respond|отвечать
response|ответ
restless|беспокойный
restore|восстановить
resume|резюме
retire|уходить в отставку
retreat|отступление
reward|награда
rib|ребро
riddle|загадка
ridge|хребет
ridiculous|нелепый
rifle|винтовка
rim|обод
rip|рвать
risk|риск
rob|грабить
robot|робот
roger|Роджер
root|корень
rot|гниль
rouse|разбудить
route|маршрут
royal|королевский
rude|грубый
rumble|гул
russian|русский
rustle|шорох
rusty|ржавый
sack|мешок
sacred|священный
sacrifice|жертва
safety|безопасность
sail|плыть
sailor|моряк
sake|ради
salt|соль
salute|салют
sand|песок
satisfaction|удовлетворение
satisfy|удовлетворять
saturday|суббота
savage|дикий
sawyer|сойер
scale|шкала
scarce|скудный
scarlet|алый
scatter|разброс
scent|запах
scheme|схема
scholar|ученый
science|наука
scientific|научный
score|счет
scowl|хмуриться
scramble|схватка
scrap|лом
scratch|царапать
screw|винт
seal|тюлень
season|сезон
section|раздел
secure|безопасный
security|безопасность
seldom|редко
sensation|ощущение
sensible|разумный
sentence|предложение
separate|отдельный
september|сентябрь
sergeant|сержант
serpent|змея
severe|серьезный
sex|секс
shade|тень
shadowy|теневой
shaft|вал
shallow|мелкий
shame|стыд
shatter|разбивать
shave|бритье
shawn|Шон
shed|сбрасывать
sheep|овца
sheer|явный
sheet|лист
shelf|полка
shell|оболочка
shelter|приют
shelve|полка
sherlock|шерлок
shield|щит
shift|смена
shimmer|мерцание
shirt|рубашка
shiver|дрожь
shoe|башмак
shove|засунуть
shower|душ
shriek|визг
shrill|пронзительный
shrug|пожимание плечами
shudder|содрогаться
shuffle|перетасовать
shutter|затвор
sick|больной
sideway|боком
signal|сигнал
silk|шелк
similar|похожий
sin|грех
singular|единственное число
sinister|зловещий
sip|глоток
situation|ситуация
sixty|шестьдесят
skill|навык
skirt|юбка
skull|череп
slab|плита
slam|слэм
slant|наклонный
slap|шлепок
slave|раб
slay|убить
sleepy|сонный
sleeve|рукав
slice|ломтик
slide|слайд
slop|помои
smaller|меньше
smart|умный
smash|разгромить
snake|змея
snarl|рычание
snatch|рывок
sneak|прокрасться
sneer|презрительная усмешка
sniff|нюхать
snore|храпеть
snort|фырканье
soak|замачивать
soar|парить
sob|рыдать
social|социальный
sock|носок
sofa|диван
soften|смягчить
soil|почва
soldier|солдат
sole|подошва
solemn|торжественный
solid|твердый
solitary|одинокий
solution|решение
somebody|кто-нибудь
somewhat|несколько
sooner|скорее
sore|больной
sorrow|печаль
soup|суп
source|источник
southern|южный
southward|на юг
spare|запасной
spark|искра
sparkle|искриться
sparkler|искра
speaker|спикер
spear|копье
specimen|образец
spectacle|зрелище
specter|призрак
spider|паук
spin|вращаться
spite|злость
splash|всплеск
splendid|великолепный
split|расколоть
spoon|ложка
sport|спорт
sprawl|разрастание
spray|спрей
squat|приседать
squeak|писк
squeeze|сжимать
squint|косоглазие
stab|удар ножом
stable|стабильный
stack|куча
staff|персонал
stage|этап
stagger|шататься
stain|пятно
staircase|лестница
stalk|стебель
stamp|штамп
standard|стандарт
stare|смотреть
startle|испугать
starve|голодать
statement|заявление
statue|статуя
steam|пар
steel|сталь
steep|крутой
steeple|шпиль
steer|рулить
stern|суровый
steward|стюард
stiff|жесткий
stock|запас
stomach|желудок
stony|каменистый
stool|табурет
stoop|сутулиться
store|магазин
storm|шторм
stout|крепкий
straighten|выпрямить
strain|напряжение
strap|ремень
straw|солома
stray|бродить
stre|стрет
strict|строгий
stride|шаг
strip|полоска
stroke|гладить
stroll|прогулка
structure|структура
stumble|спотыкаться
stun|оглушить
style|стиль
substance|вещество
subtle|тонкий
succeed|преуспевать
success|успех
successful|успешный
suck|сосать
sufficient|достаточный
sugar|сахар
suggestion|предположение
sullen|угрюмый
sum|сумма
summon|вызывать
sunday|воскресенье
sunlight|солнечный свет
sunset|закат
superior|начальник
supper|ужин
supple|гибкий
supply|поставлять
support|поддерживать
suppress|подавлять
supreme|верховный
surround|окружать
survey|опрос
survive|выживать
suspect|подозревать
suspicion|подозрение
suspicious|подозрительный
swallow|глотать
swarm|рой
sway|качаться
swear|ругаться
sweat|пот
sweeper|уборщик
swell|зыбь
swim|плавать
swirl|вихрь
switch|выключатель
swoop|пикировать
symbol|символ
sympathy|сочувствие
system|система
talent|талант
tangle|запутываться
taste|вкус
teach|учить
teacher|учитель
team|команда
telephone|телефон
temper|характер
temple|храм
temporary|временный
tempt|соблазнять
tend|иметь тенденцию
tender|нежный
tense|напряженный
tent|палатка
terrace|терраса
terrify|ужасать
terrorist|террорист
test|тест
thee|тебя
theory|теория
thief|вор
thieve|вор
thirteen|тринадцать
thomas|томас
thorough|тщательный
thou|ты
thoughtful|вдумчивый
thread|нить
threat|угроза
threaten|угрожать
throb|пульсация
throne|трон
thrust|толкать
thud|глухой удар
thumb|большой палец
thump|стук
thunder|гром
thy|твой
tick|клещ
ticket|билет
tide|прилив
tidings|вести
timid|робкий
tin|олово
title|заголовок
toast|тост
toe|палец ноги
tomb|могила
tool|инструмент
torch|факел
torment|мучение
torture|пытка
toss|бросать
total|общий
tough|жесткий
tournament|турнир
toy|игрушка
trade|торговля
tradition|традиция
traffic|трафик
trail|тащить
trap|ловушка
traveller|путешественник
tray|поднос
tread|протектор
treasure|сокровище
treat|обращаться
tremendous|огромный
trial|пробный
trick|обманывать
trickle|струйка
trifle|мелочь
trip|поездка
triumph|триумф
troll|тролль
troop|отряд
trot|рысь
trouser|брюки
truck|грузовик
tube|трубка
tuck|складка
tug|буксир
tumble|падение
tune|мелодия
twelve|двенадцать
twilight|сумерки
twin|близнец
twinkle|мерцание
twitch|дергаться
type|тип
ultimate|окончательный
unable|неспособный
uncertain|неопределенный
uncomfortable|неудобно
unconscious|бессознательный
underground|под землей
underneath|под
undoubted|несомненный
uneasy|беспокойный
unexpected|неожиданный
unfortunate|неудачный
unhappy|несчастный
unicorn|единорог
uniform|униформа
union|союз
unit|единица
universal|универсальный
universe|вселенная
university|университет
unlike|в отличие от
unlock|разблокировать
unpleasant|неприятный
unseen|невидимый
unusual|необычный
upper|верхний
upright|вертикально
upset|расстроенный
upstairs|наверх
upward|вверх
urge|побуждать
urgent|срочный
useful|полезный
useless|бесполезный
utmost|предельный
vain|тщетный
valentine|валентинка
value|ценить
variety|разнообразие
vary|отличаться
vault|сейф
veil|вуаль
vein|вена
velvet|бархат
venture|риск
victim|жертва
victory|победа
violent|жестокий
violet|фиолетовый
virtue|добродетель
visible|видимый
vision|зрение
visitor|посетитель
vital|жизненно важный
vivid|яркий
volume|объем
wade|пробираться
wail|вопль
waist|талия
waistcoat|жилет
waiter|официант
wan|бледный
warmth|тепло
warrior|воин
wary|осторожный
waste|напрасно тратить
watcher|наблюдатель
watson|уотсон
wax|воск
weakness|слабость
wealth|богатство
weather|погода
weave|ткать
web|веб
wed|обвенчались
weep|плакать
weigh|весить
weird|странный
western|западный
westward|на запад
wet|мокрый
whence|откуда
whenever|в любое время
wherever|где бы то ни было
whilst|в то время как
whip|хлыст
whirl|вихрь
whistle|свист
whoever|кто бы ни
wick|фитиль
widow|вдова
william|Уильям
willow|ива
wink|подмигивание
winter|зима
wipe|вытирать
wire|проволока
wisdom|мудрость
wit|остроумие
wither|увядать
witness|свидетель
wobbler|воблер
wolf|волк
wooden|деревянный
worm|червь
worship|поклонение
worthy|достойный
wrap|сворачивать
wreck|крушение
wrench|гаечный ключ
wretch|негодяй
wrinkle|морщина
wrist|запястье
writhe|корчиться
wrought|кованый
yawn|зевать
yesterday|вчера
yield|урожай
younger|моложе
of|от
to|к
and|и
in|в
is|является
it|это
you|ты
that|что
he|он
was|был
for|для
on|на
are|являются
with|с
as|как
I|Я
his|его
they|они
be|быть
at|в
one|один
have|иметь
this|этот
from|от
or|или
had|имел
by|к
not|нет
word|слово
but|но
what|что
some|некоторый
we|мы
can|может
out|вне
other|другой
were|были
all|все
there|там
when|когда
up|вверх
use|использовать
your|твой
how|как
said|сказал
an|а
each|каждый
she|она
which|который
do|делать
their|их
time|время
if|если
will|воля
way|способ
about|о
many|много
then|затем
them|их
write|писать
would|бы
like|нравиться
so|так
these|эти
her|ее
long|длинный
make|делать
thing|вещь
see|видеть
him|ему
two|два
has|имеет
look|смотреть
more|более
day|день
could|мог
go|идти
come|приходить
did|делал
number|число
sound|звук
no|нет
most|большинство
people|люди
my|мой
over|над
know|знать
water|вода
than|чем
call|звонок
first|первый
may|может
down|вниз
side|сторона
been|был
now|сейчас
find|находить
any|любой
new|новый
work|работа
part|часть
take|брать
get|получать
place|место
made|сделал
live|жить
where|где
after|после
back|назад
little|маленький
only|только
round|круглый
man|мужчина
year|год
came|пришел
show|показывать
every|каждый
good|хороший
me|мне
give|давать
our|наш
under|под
name|имя
very|очень
through|через
just|только
form|форма
sentence|предложение
great|большой
think|думать
say|сказать
help|помогать
low|низкий
line|линия
differ|отличаются
turn|повернуть
cause|причина
much|много
mean|иметь в виду
before|до
move|двигаться
right|верно
boy|мальчик
old|старый
too|слишком
same|такой же
tell|рассказывать
does|делает
set|набор
three|три
want|хотеть
air|воздух
well|хорошо
also|также
play|играть
small|маленький
end|конец
put|помещать
home|дом
read|читать
hand|рука
port|порт
large|большой
spell|заклинание
add|добавлять
even|даже
land|земля
here|здесь
must|должен
big|большой
high|высокий
such|такой
follow|следовать
act|действовать
why|почему
ask|просить
men|мужчины
change|изменять
went|шел
light|свет
kind|добрый
off|выключенный
need|нуждаться
house|дом
picture|картина
try|пытаться
us|нас
again|снова
animal|животное
point|точка
mother|мать
world|мир
near|около
build|строить
self|себя
earth|земля
father|отец
head|голова
stand|стоять
own|собственный
page|страница
should|должен
country|страна
found|найденный
answer|отвечать
school|школа
grow|расти
study|изучать
still|все еще
learn|учиться
plant|растение
cover|крышка
food|еда
sun|солнце
four|четыре
between|между
state|состояние
keep|держать
eye|глаз
never|никогда
last|последний
let|позволять
thought|мысль
city|город
tree|дерево
cross|крест
farm|ферма
hard|жесткий
start|начинать
might|мощь
story|история
saw|пила
far|далеко
sea|море
draw|рисовать
left|левый
late|поздно
run|бегать
don't|не
while|пока
press|нажимать
close|закрывать
night|ночь
real|настоящий
life|жизнь
few|немного
north|север
open|открыть
seem|казаться
together|вместе
next|следующий
white|белый
children|дети
begin|начинать
got|получил
walk|ходить
example|пример
ease|простота
paper|бумага
group|группа
always|всегда
music|музыка
those|те
both|оба
mark|отметка
often|часто
letter|письмо
until|до
mile|миля
river|река
car|машина
feet|ноги
care|заботиться
second|второй
book|книга
carry|нести
took|взял
science|наука
eat|есть
room|комната
friend|друг
began|начал
idea|идея
fish|рыба
mountain|гора
stop|останавливаться
once|один раз
base|база
hear|слышать
horse|лошадь
cut|резать
sure|уверен
watch|смотреть
color|цвет
face|лицо
wood|древесина
main|основной
enough|достаточно
plain|простой
girl|девочка
usual|обычный
young|молодой
ready|готовый
above|выше
ever|всегда
red|красный
list|список
though|хотя
feel|чувствовать
talk|разговаривать
bird|птица
soon|скоро
body|тело
dog|собака
family|семья
direct|прямой
pose|поза
leave|оставлять
song|песня
measure|мера
door|дверь
product|продукт
black|черный
short|короткий
numeral|цифра
class|класс
wind|ветер
question|вопрос
happen|случаться
complete|полный
ship|корабль
area|область
half|половина
rock|камень
order|заказ
fire|огонь
south|юг
problem|проблема
piece|кусок
told|сказал
knew|знал
pass|проходить
since|с тех пор
top|вершина
whole|весь
king|король
space|космос
heard|слышал
best|лучший
hour|час
better|лучше
true|истинный
during|в течение
hundred|сто
five|пять
remember|помнить
step|шаг
early|рано
hold|держать
west|запад
ground|земля
interest|интерес
reach|достигать
fast|быстрый
verb|глагол
sing|петь
listen|слушать
six|шесть
table|стол
travel|путешествовать
less|меньше
morning|утро
ten|десять
simple|простой
several|несколько
vowel|гласный
toward|к
war|война
lay|класть
against|против
pattern|узор
slow|медленный
center|центр
love|любовь
person|человек
money|деньги
serve|служить
appear|появляться
road|дорога
map|карта
rain|дождь
rule|правило
govern|управлять
pull|тянуть
cold|холодный
notice|уведомление
voice|голос
unit|единица
power|власть
town|город
fine|отлично
certain|определенный
fly|летать
fall|падать
lead|вести
cry|плакать
dark|темный
machine|машина
note|примечание
wait|ждать
plan|план
figure|фигура
star|звезда
box|коробка
noun|существительное
field|поле
rest|отдых
correct|правильный
able|способный
pound|фунт
done|сделанный
beauty|красота
drive|водить машину
stood|стоял
contain|содержать
front|передний
teach|учить
week|неделя
final|финал
gave|отдал
green|зеленый
oh|ох
quick|быстрый
develop|развивать
ocean|океан
warm|теплый
free|бесплатно
minute|минута
strong|сильный
special|особенный
mind|разум
behind|позади
clear|прозрачный
tail|хвост
produce|производить
fact|факт
street|улица
inch|дюйм
multiply|умножить
nothing|ничего
course|курс
stay|оставаться
wheel|колесо
full|полный
force|сила
blue|синий
object|объект
decide|решать
surface|поверхность
deep|глубокий
moon|луна
island|остров
foot|ступня
system|система
busy|занятый
test|тест
record|записывать
boat|лодка
common|общий
gold|золото
possible|возможный
plane|самолет
stead|удерживать
dry|сухой
wonder|удивляться
laugh|смеяться
thousand|тысяча
ago|назад
ran|побежал
check|проверять
game|игра
shape|форма
equate|приравнивать
hot|горячий
miss|скучать
brought|принес
heat|нагревать
snow|снег
tire|шина
bring|приносить
yes|да
distant|далекий
fill|наполнять
east|восток
paint|краска
language|язык
among|среди
grand|большой
ball|мяч
yet|еще
wave|волна
drop|уронить
heart|сердце
am|ам
present|подарок
heavy|тяжелый
dance|танец
engine|двигатель
position|позиция
arm|рука
wide|широкий
sail|плыть
material|материал
size|размер
vary|отличаться
settle|решить
speak|говорить
weight|вес
general|общий
ice|лед
matter|иметь значение
circle|круг
pair|пара
include|включать
divide|разделять
syllable|слог
felt|чувствовал себя
perhaps|возможно
pick|выбирать
sudden|внезапный
count|считать
square|квадрат
reason|причина
length|длина
represent|представлять
art|искусство
subject|предмет
region|область
energy|энергия
hunt|охота
probable|вероятный
bed|кровать
brother|брат
egg|яйцо
ride|поездка
cell|клетка
believe|полагать
fraction|дробь
forest|лес
sit|сидеть
race|гонка
window|окно
store|магазин
summer|лето
train|тренироваться
sleep|спать
prove|доказывать
lone|одинокий
leg|нога
exercise|упражнение
wall|стена
catch|ловить
mount|монтировать
wish|желать
sky|небо
board|доска
joy|радость
winter|зима
sat|сидел
written|написано
wild|дикий
instrument|инструмент
kept|сохранено
glass|стекло
grass|трава
cow|корова
job|работа
edge|край
sign|знак
visit|посещать
past|прошлое
soft|мягкий
fun|веселье
bright|яркий
gas|газ
weather|погода
month|месяц
million|миллион
bear|медведь
finish|заканчивать
happy|счастливый
hope|надеяться
flower|цветок
clothe|одеть
strange|странный
gone|ушел
jump|прыжок
baby|малыш
eight|восемь
village|деревня
meet|встретиться
root|корень
buy|купить
raise|поднимать
solve|решать
metal|металл
whether|ли
push|толкать
seven|семь
paragraph|абзац
third|третий
shall|должен
held|держал
hair|волосы
describe|описывать
cook|готовить
floor|этаж
either|либо
result|результат
burn|гореть
hill|холм
safe|безопасный
cat|кот
century|век
consider|учитывать
type|тип
law|закон
bit|кусочек
coast|побережье
copy|копия
phrase|фраза
silent|тихий
tall|высокий
sand|песок
soil|почва
roll|рулон
temperature|температура
finger|палец
industry|промышленность
value|ценить
fight|драться
lie|ложь
beat|бить
excite|возбуждать
natural|естественный
view|вид
sense|смысл
ear|ухо
else|еще
quite|довольно
broke|сломанный
case|случай
middle|середина
kill|убийство
son|сын
lake|озеро
moment|момент
scale|шкала
loud|громкий
spring|весна
observe|наблюдать
child|ребенок
straight|прямой
consonant|согласный
nation|нация
dictionary|словарь
milk|молоко
speed|скорость
method|метод
organ|орган
pay|платить
age|возраст
section|раздел
dress|одеваться
cloud|облако
surprise|сюрприз
quiet|тихий
stone|камень
tiny|крошечный
climb|взбираться
cool|прохладный
design|дизайн
poor|бедный
lot|много
experiment|эксперимент
bottom|нижний
key|ключ
iron|железо
single|одинокий
stick|палка
flat|плоский
twenty|двадцать
skin|кожа
smile|улыбка
crease|складка
hole|дыра
trade|торговля
melody|мелодия
trip|поездка
office|офис
receive|получать
row|ряд
mouth|рот
exact|точный
symbol|символ
die|умирать
least|наименее
trouble|беда
shout|кричать
except|кроме
wrote|написал
seed|семя
tone|тон
join|присоединиться
suggest|предлагать
clean|чистый
break|перерыв
lady|леди
yard|площадка
rise|рост
bad|плохой
blow|дуть
oil|масло
blood|кровь
touch|трогать
grew|вырос
cent|цент
mix|смешивать
team|команда
wire|проволока
cost|стоимость
lost|потерянный
brown|коричневый
wear|носить
garden|сад
equal|равный
sent|отправлено
choose|выбирать
fell|упал
fit|соответствовать
flow|поток
fair|справедливый
bank|банк
collect|собирать
save|сохранять
control|контроль
decimal|десятичный
gentle|нежный
woman|женщина
captain|капитан
practice|практиковать
separate|отдельный
difficult|трудный
doctor|доктор
please|пожалуйста
protect|защищать
noon|полдень
whose|чей
locate|найти
ring|кольцо
character|характер
insect|насекомое
caught|пойман
period|период
indicate|указывать
radio|радио
spoke|говорил
atom|атом
human|человек
history|история
effect|эффект
electric|электрический
expect|ожидать
crop|урожай
modern|современный
element|элемент
hit|ударять
student|студент
corner|угол
party|вечеринка
supply|поставлять
bone|кость
rail|рельс
imagine|представлять себе
provide|предоставлять
agree|соглашаться
thus|таким образом
capital|капитал
won't|не будет
chair|стул
danger|опасность
fruit|фрукты
rich|богатый
thick|толстый
soldier|солдат
process|процесс
operate|работать
guess|предполагать
necessary|необходимый
sharp|острый
wing|крыло
create|создавать
neighbor|сосед
wash|стирать
bat|летучая мышь
rather|скорее
crowd|толпа
corn|кукуруза
compare|сравнивать
poem|стихотворение
string|нить
bell|колокол
depend|зависеть
meat|мясо
rub|руб
tube|трубка
famous|известный
dollar|доллар
stream|транслировать
fear|страх
sight|зрение
thin|тонкий
triangle|треугольник
planet|планета
hurry|торопиться
chief|главный
colony|колония
clock|часы
mine|мой
tie|галстук
enter|входить
major|главный
fresh|свежий
search|поиск
send|отправлять
yellow|желтый
gun|пистолет
allow|позволять
print|печать
dead|мертвый
spot|место
desert|пустыня
suit|подходить
current|текущий
lift|поднимать
rose|роза
continue|продолжать
block|блокировать
chart|диаграмма
hat|шляпа
sell|продавать
success|успех
company|компания
subtract|вычитать
event|событие
particular|особый
deal|иметь дело
swim|плавать
term|срок
opposite|противоположный
wife|жена
shoe|башмак
shoulder|плечо
spread|распространение
arrange|договариваться
camp|лагерь
invent|изобретать
cotton|хлопок
born|рожденный
determine|определять
quart|кварта
nine|девять
truck|грузовик
noise|шум
level|уровень
chance|шанс
gather|собирать
shop|магазин
stretch|потягиваться
throw|бросать
shine|светить
property|свойство
column|столбец
molecule|молекула
select|выбирать
wrong|неправильный
gray|серый
repeat|повторить
require|требовать
broad|широкий
prepare|подготовить
salt|соль
nose|нос
plural|множественное число
anger|гнев
claim|требовать
continent|континент
oxygen|кислород
sugar|сахар
death|смерть
pretty|симпатичный
skill|навык
women|женщины
season|сезон
solution|решение
magnet|магнит
silver|серебро
thank|благодарить
branch|ветвь
match|соответствовать
suffix|суффикс
especially|особенно
fig|инжир
afraid|испуганный
huge|огромный
sister|сестра
steel|сталь
discuss|обсуждать
forward|вперед
similar|похожий
guide|гид
experience|опыт
score|счет
apple|яблоко
bought|купил
led|вел
pitch|подача
coat|пальто
mass|масса
card|карта
band|группа
rope|веревка
slip|соскальзывать
win|победить
dream|мечтать
evening|вечер
condition|состояние
feed|кормить
tool|инструмент
total|общий
basic|базовый
smell|запах
valley|долина
nor|ни
double|двойной
seat|сиденье
arrive|приезжать
master|мастер
track|отслеживать
parent|родитель
shore|берег
division|разделение
sheet|лист
substance|вещество
favor|услуга
connect|соединять
post|почта
spend|тратить
chord|аккорд
fat|толстый
glad|радостный
original|оригинальный
share|делиться
station|станция
dad|папа
bread|хлеб
charge|заряжать
proper|правильный
bar|бар
offer|предложение
segment|сегмент
slave|раб
duck|утка
instant|мгновенный
market|рынок
degree|степень
populate|заселять
chick|цыпленок
dear|дорогой
enemy|враг
reply|отвечать
drink|напиток
occur|происходить
support|поддерживать
speech|речь
nature|природа
range|диапазон
steam|пар
motion|движение
path|путь
liquid|жидкость
log|бревно
meant|имел в виду
quotient|частное
teeth|зубы
shell|оболочка
neck|шея